智能生活	智能生活
READfit	READfit
Fidget_Spinner	指尖陀螺
宝宝运动会	宝宝运动会
腹部锻炼	腹部锻炼
PICOOC	PICOOC
funny_Games	趣游戏
3D_动态壁纸	动态壁纸
二战风云	二战风云
Tap_Metronome_-_节拍器	滴答节拍器-节拍器
阿瑞斯病毒	阿瑞斯病毒
FootballR	足球侠
手机搬家	手机搬家
My_Diary	吾记日记
Quick_Loans	快贷
MY_TV	我的电视
Haylou_Fun	Haylou_Fun
Vision+	Vision2
Bible	圣经
Due_Date_Calculator	预产期计算器
火柴人战场	火柴人英雄战场
QQ邮箱	QQ邮箱
Manga_Clash_-_Warrior_Arena	Manga_Clash_-_Warrior_Arena
宝宝台风天气	宝宝台风天气
7分钟锻炼免费	7分钟锻炼
街头篮球	街头篮球
Project_Manager	项目经理
Love_Art	爱艺术+
荒野战斗宝箱模拟器	荒野战斗宝箱模拟器
qMenu	菜谱
Vida_Saludable	健康扬帆
Rental_Home	租借之家
漫威:_超级争霸战	漫威：超级争霸战
简历创建者	个人简历制作
Crzay_Fishing	疯狂钓鱼
Health_Benefits	健康恩泽
羽毛球高高手	羽毛球高高手
动漫_装扮_头像制作	动漫卡通头像制作
Coin_World	币世界
国泰航空	国泰航空
快速阅读	快读书
XBrowser	X浏览器
Simple_Weather	简单天气
停站竞赛_:_经纪人	停站竞赛：经纪人
Personal_e-Library	个人图书馆
Truck_Simulator	卡车模拟器
Secret_Agent	秘密特工
Photo_Editor	Photo_Editor
发展帝国：罗马_(Grow_Empire:_Rome)	成长帝国：罗马
简单的笔记	简易便签
Construction_Jobs	筑作
Photo_Editor	照片编辑器
Tower_Defense_Heroes_2	塔防英雄2
Star_Taxi	星星打车
奇妙美味日记	奇妙美味日记
屏幕录像机	录屏
DS_video	DS_video
Seven_Knights	七骑士
我的勇者	我的勇者
微博国际版	微博国际版
米家	米家
迅游手游加速器	迅游手游加速器
抑郁症测试	抑郁症测试
照顾小宝宝	照顾小宝宝
Hej_Tid	计时器Timer
全球实时天气	全国实时天气
Poster_Maker	海报制作大师
合力救援	合力救援
快速新闻	速新闻
Photo_Gallery	拍库
Birthday_Photo_Editor	Birthday_Photo_Editor
HP_Print_Service_插件	HP_打印服务插件
通讯录	通讯录+
Hair_Salon	发型屋
Island_Survival	岛屿生存
Kosiski_Auto_Parts	开思汽配
名人站	名人站
Kurir	闪送员
万豪旅享家	万豪旅享家
Fairy_Tales	童话故事
幸運符	幸运符
澳覓	澳觅
Think	以为
Save_money	省钱
今日头条	今日头条
Poke_Wallpapers	口袋壁纸
魔漫相机	魔漫相机
汇丰银行	汇丰银行
Video_Ringtone	视频铃声
Super_Tank	超级坦克
Traditional_Chinese_Medicine,_Medicinals	国药健康
Proxima_Centauri	比邻星
TouchRetouch	TouchRetouch
My_Links	我的链接
Free_video_downloader	免费视频下载器
Cuentos_Infantiles_Para_Niños	儿童故事
AroundMe	身边
Deep_Translator	亲爱的翻译官
变形金刚：百炼为战	变形金刚：百炼为战
倒放挑战	倒放挑战HQ
中医方剂	中医家
见缝插针	见缝插针
义乌购	义乌购
淘宝特价版	淘宝特价版
全能视频下载器	全能视频下载器
Word_Cloud_Art_Generator	词云图生成器
Follow_up	随动
DS_photo	DS_photo
Chandan_Logics	承达物流
Повесть_о_приключениях_Артура	阿尔托的冒险
掌上火车票12306抢票	铁友火车票12306抢票
Rope_Hero	绳索英雄
Snail_Ride	蜗牛行
Business_communication	营商通
国际跳棋游戏	国际跳棋
Snapseed	Snapseed
男性家庭锻炼	男性家庭锻炼
Cloud_Raiders	云骑
Local_Weather	本地天气
Zoom	Zoom
Kitchen_Storage	厨房故事
Zombie_Tsunami_(僵尸尖叫)	僵尸尖叫
Smart_Watch	智慧水务
Notepad	便签本
Flash	飞闪
Mkash_loans	现金贷款
Video_Downloader	视频下载器
IQ_Test	智商测试
Happy_Sports	开心运动
电台广播	FM收音机广播
每周的日程计划	每周计划
Auphonic_Edit	音频编辑器
Mahabharatha_tones	酷爱点
猜猜看	猜猜这是谁
Healing_Power	头条电力
Wedding_Inspirations	婚礼请柬
围棋	围棋
Compass	指南针罗盘
Kick_the_wall	踢墙
Jewelry_Outlet	珠宝管家
Drum_Machine	梦境机器
Alarm_Clock	闹钟
SleepTown_睡眠小镇	SleepTown
二维码生成器	二维码生成器
Candy_Legend	糖果传奇
Fitbit	Fitbit
National_Geographic_DE	国家地理
微博	微博
Southwest_Airlines	南方航空
浪荡天涯	浪荡天涯
Daily_News	曰讯
Compound_Interest_Calculator	复利计算
Clumsy_Ninja	笨拙的忍者
Manager	管理者
Inspection	检一检
Leader_Life	Leader_Life
天气预报小部件	天气预报王
测距仪	尺子测距仪
Alpha_1	Alpha_1
有我看家	有我看家
4G_Hotspot	上热点
PDF_效用	PDF_效用
宝宝果汁商店	宝宝果汁商店
File_Explorer	ES文件浏览器
Rice_Burner	饭角
아이돌_뷰티샵	偶像美容店
Lisk_Wallet	财客钱包
迅游手游加速器	迅雷手游加速器
DISC_LINK_Platinum	DISC_LINK_Platinum
宝宝交通工具书	宝宝交通工具书
奇妙怪物美容	奇妙怪物美容
过山车火车模拟器	过山车模拟器
Complete_Physics	论文大全
汤姆猫的摩托艇_2	汤姆猫的摩托艇
减肥食谱	减肥食谱
Ultimate_Fox_Simulator	终极狐狸模拟器
一嗨租车	一嗨租车
Mindfulness_Meditation	Now正念冥想
Tank_Battle	坦克大作战
Photo_Editor_Pro	Photo_Editor_Pro
Click	咔嗒
Word_Master	word制作大师
新浪财经	新浪财经
Volume_Calculator	材积计算器
Express_Driver	快运滴司机
陰陽師：百聞牌	阴阳师:百闻牌
Truck_Simulator_:_Offroad	卡车模拟：越野
新浪新闻	新浪新闻
Housing_Loan_Calculator	房贷款计算器
Fishing_timer	业鱼时间
Speed_Spot	速博体育
猫里奥	猫里奥
战舰世界闪击战	战舰世界闪击战
真心话大冒险	真心话大冒险
Financial_Peace	金融苑
分贝计	分贝仪
MTrader	交易侠
Credit_Card_Manager	51信用卡管家
Express_News	快报报
Electrical_Calculator	电工计算器
Bridge_Builder	大桥建设者
薄荷记账	薄荷记账
My_Piano	我的钢琴
Funny_Jokes	搞笑段子
Financial_Times	金融时报
Image_Editor	PS图片编辑器
White_Noise	白噪音
安可达_(Agoda)	Agoda安可达
Investment_tips	投资加
汤姆猫跑酷	汤姆猫跑酷
Harvard_Business_Review	哈佛商业评论
声波清理大师	声波清理大师
Catatan_Hutang_Piutang	饮食记
Football_Career	足球咖
Equine_Medical_Services	联合医务
企鹅电竞直播助手	企鹅电竞直播助手
相机360	相机360
FIMI_Navi_2020	FIMI_Navi_2020
屏幕录像机	屏幕录像
Dolphin_Tv	海豚TV
模拟农场	模拟农场16
美国中文电台_美国中文收音机_全球多国_华语电台_US_Chinese_Radio	ChinaRadio
银河大战	银河大战
Play!	玩会
Fish_Adventure	捕鱼大冒险
EVA_Mobile	EVA_Mobile
Coremail论客	Coremail论客
Friendz	即友
奇妙咖啡餐厅	奇妙咖啡餐厅
象棋	象棋
Idle_City_Builder	闲置城市建造者
Citi_News	城市快讯
我在大清當皇帝	我在大清当皇帝
随身乐队	随身乐队
Mental_Health	美牙健康
Weather_Forecast	天气通天气预报
拼多多	拼多多
Carmin_Lite	卡民生活
黑洞大作战	黑洞大作战
Bedtime_Stories	睡前小故事
nura	nura
Java_Programming_App	Java编程狮
Community	C社区
Collage_Maker	Collage_Maker
Private_Browser	私密浏览器
Dawn_of_Steel	钢之黎明
Body_Plastic_Surgery	如丽整形
柬埔寨头条	柬埔寨头条
เรื่องเล่าผี	鬼故事
Cube_Escape:_Case_23	立方逃脱：洞穴
Love_Story	恩爱记
讯飞输入法	讯飞输入法
Bible_Chat	泡泡聊天
Аёллар_кассаликлар	数科
都都数学	都都数学
AccuroFit	AccuroFit
大提琴调音器	大提琴调音器
宝宝巴士习惯班	宝宝巴士习惯班
HealthMate	Health_Mate
Lucky_Block	确幸股票
超级星鱼	超级海星
Azuro:_Property_Management	智慧物管
Astrological_Charts	占星猫
Micro_Finance	微品金融
My-Store	偶的店
Internet_Cafe_Simulator	网吧模拟器
护眼滤镜	护眼大师
Leap_Day	闰日
3B_Meteo_-_Previsioni_Meteo	口袋天气-天气预报
Interval_Timer	间隔计时器
Space_Expedition	太空远征队
卡通射手2:_自由职业者	卡通射手2：自由职业者
Maze_Puzzle	懒人拼图
Skateboard_tricks	滑板圈
宝宝学数字	宝宝学数字
Material_Power_Menu	材力邦
Chat	聊聊
Picture_Game	画框框
向日葵远程控制	向日葵远程控制
在你身后！	在你身后
3D_Tank_Battle	3D坦克争霸2
小孩学英语	儿童学英语
搞怪铃声	趣铃声
图片编辑器	图片编辑器
物理弹球	物理小球
有型_-_型男专属自拍相机	有型型男专属自拍相机
Star21_Media	星传媒
要塞围城	要塞围城
疯狂赛车	疯狂阅读
Home_Decoration_Ideas	家装帮
期间日历	Persian_Calendar
Food_Crush	美食刷刷
Love_Me	爱我
yellow	黄色
挑战巅峰	挑战巅峰
Drift_Zone	漂移地带
SMART-TIME_PRO	SMART-TIME_PRO
拳皇命運	拳皇命运
最強蝸牛	最强蜗牛
在_30_天内练就六块腹肌	30天练出六块腹肌
Warship_Battle	战舰激斗
Daily_Readings	天天小读
National_Geographic_DE	华夏地理
飞行棋	飞行棋
英语电台FM收音机	英语电台FM收音机
ZY_Play	ZY_Play
Flash	闪现
微软资讯	微家居资讯
Spectacular	壮观
Barbie_Dreamhouse_Adventures	芭比梦幻屋冒险
FM_收音机	FM收音机
Weight_Loss_Goal	减肥餐
Tap_Metronome_-_节拍器	鼓点节拍器-节拍器
Online_Classroom	Apa在线教室
Civil_Engineering_Magazine	土木在线
Time_is_Money	时间就是金钱
Simple_Meditation	简单冥想
Image_Scanner	图像扫描仪
Body_Language	体语
Online_Shopping	民e购
Congresos	聚料
Savings_Track	储蓄罐
Bhagavad_Gita_in_Hindi_-_संपूर्ण_भगवद_गीता	小孩图画书
Direct_News	直新闻
Mobile_Remote_Control	手机遥控器
语音转文字	语音转文字
CamHipro	CamHipro
Road_House	路之家
Observador	观察者
1byone_Health	1byone_Health
Loop	Loop
Flip_Clock-7	翻页时钟
Elderly_care	C养老
Construction_Calculator	建工计算器
Momentos	Moments
Laser_Tower_Defense	花塔防御
CamHi	CamHi
赚钱博客	赚钱帮
街機達人捕魚	街机达人捕鱼
Zenly：你的专属地图，你的伙伴们	Zenly:_你的专属地图，你的伙伴们
特技水运	特技水运
Weapon_Girls	兵器少女
StoreMyStore_-_Business	店店店
The_laws_of_seduction	育之有道
トゥギャッター_/_話題のネタやニュースをまとめてチェック！	小验一下
Spoken_English_E2B	英语口语100
Coleções	拾集
Mermaid_Underwater_World	美人鱼海底派对
Wansview	Wansview
个人简历	简历
政务微信	政务微信
Prime_pagine	初页
泡泡魔女传奇3	泡泡魔女传奇3
Smart_Study	智慧书房
Circle	园圈
大悲咒佛教音乐	佛教音乐-大悲咒
Marvel_Unlimited	漫威无限
Tractor	拖拉机
截图工具	截图工具
Ancestor	先祖
BEA_東亞銀行	东亚银行
分动	分动
The_Information	搜狐资讯
Voice_Changer	变声器
CamViews	CamViews
Flash_Dutch	闪批
有鱼智投	有鱼智投
Coin_Collection	硬币收藏
Smart_Quran	智慧阜南
心诚则灵	心诚则灵
Bus_Simulator_2017	客车模拟器2020
daytoday_health	每天健康
USB_Camera2	USB摄像头
Express_Driver	37Express_Driver
貪吃蛇進化論	贪吃蛇进化论
Speech_To_Text	语音转换文字
China_News	中国网
各种各样的人	各种各样的人
Octopus	Octopus
Stream_Vision	Stream_Vision
WearFit2.0	WearFit2.0
千炮达人捕鱼	千炮疯狂捕鱼
ධම්ම_පදය	Slow
Chasing_Zombies	追追漫画
Daily_Fresh	每日优鲜
Dinámicas_Sociales	本地动态
Mobile_TV	手机电视
My_Planet	我的行星
Huion_Sketch	Huion_Sketch
极限着陆	极限着陆
Quick_Dial	速设印章
Leader	领家
智家365	智家365
炸弹小分队	炸弹小分队
小小矿工	小小矿工
MX_Player	MX_播放器
閃耀暖暖	闪耀暖暖
凤凰新闻	凤凰新闻
探索雅星会	探索雅星会
Ant1news	蚁讯
Cat_Simulator	猫叫模拟器
Sudoku	数独
Baking_Recipes	烘焙食谱
Broadcasting_Hut	播播TV
Mortgage_Calculator	房贷计算器LPR
建筑材料	买建材
Nubs'_Adventure	立方大冒险
我的汤姆猫2	我的汤姆猫
Pulse	脉脉
脑力激荡	脑筋急转弯
Fast_News	闪电新闻
Around_Sound	音籁
Leader	领将者
Family_Tree	亲情树
YouMe	YoMe
My_Calories	我的卡路里
反恐死亡射击	反恐死亡射击
Anytime_Fitness	爱动健身
Subway_Surfers	地铁跑酷
QCY	QCY
世界地图！	世界地图
Battleheart	战斗之心
Emergency_Call	来电救急
21相机	21相机
daytoday_health	每日健康
Harri_Live	哈尼直播
Splash（流光溢彩）	Splash
RaceFitPro	RaceFitPro
WiFi万能钥匙	WiFi万能钥匙
拓课云Plus	拓课云Plus
Kata_Sedih_Bikin_Nyesek	小小单词
影音先锋_-_播放器	先锋视频播放器
厚墨	厚墨
green	格力+
梦境侦探	梦境侦探
会说话的狗AR	会说话的狗2
海贝音乐	海贝音乐
冥想音乐	冥想音乐
Eve_Special_Forces	空中特工队
Currency_Converter	汇率换算
Driving_School_2016	驾驶学校2016
GIF_Maker	GIF大师
Business_Family	商合家
Insurance	保保
Sonos	Sonos
Friends_Book	友书
English_Reading	英语读书
Stock_Market_Simulator	模拟炒股
mywellness	mywellness
箱中少女	箱中少女
Zombie_Guard	僵尸守护者
Virtual_Line	Virtual_Life
名侦探老王	名侦探老王
Lefun_Health	乐普健康
RoCamping	房车露营
Drivetune	Drivetune
Animation_Store	动漫之家
Aladdin	阿拉订
Community_Radio	社区半径
Marketing_Assistant	营销助手
宝宝爱整理	宝宝爱整理
Pulse	Pulse
Rubik's_Cube_3D	魔方精灵
Makeup_Camera	彩妆相机
药水制作师	药水制作师
Ant_Smasher	蚂蚁终结者
Nhat_Hanh_Quotes	元气骑士
OPPLE_Smart_Lighting	欧普智慧灯光
生日提醒警报	生日提醒管家
Nebula	星云
Wallpaper_Hockey	壁纸屋
Connect	Connect
Love_Story	恋爱情话记
Forward_Assault	前锋突袭
Earth	earth地球
Write_Assistant	作家助手
Special_Forces_Group_2	特种部队小组2
Bubble_Shooter	泡泡射手
沙盒	沙盒
神秘之城:_寻物历险	神秘之城：寻物历险
Slitherlink	Siterlink
Haylou_Sport	Haylou_Sport
Anime_Wallpaper	动漫壁纸
Leader	领动者
时光日记	时光日记
QQ音乐	QQ音乐
Mortgage_Calculator	房贷计算器
宝宝地震安全2	宝宝地震安全2
南洋商业银行	南洋商业银行
Among_Us	我们之中
藝宏_ArtHola	藝弘_ArtHola
Chinese_Calendar	万年历黄历
模拟农场	模拟农场20
Event_Assistant	赛事助手
Qwatch	Qwatch
Impossible_Bike_Stunts	不可能的BMX自行车特技
宝宝巴士数学冒险	宝宝巴士数学冒险
Gun_Club_2	枪支俱乐部
万年历	万年历
Cute	萌呀
Lightning_Wallpapers	闪电壁纸
Broken_Screen_Prank	碎屏恶作剧
照片水印	照片水印
Clock	时钟
30天内减肥	30_天內减肥
Happy_News	喜信
Hack_News	海客新闻
招商永隆一点通	招商永隆一点通
Funny_Videos	搞笑视频
Flight_Simulator_787	飞行模拟器3D
青青日记	青青日记
女性健身_-_女性锻炼	女性健身-女性锻炼
精读圣经	精读圣经
Genealogy	家谱纪
懒饭	懒饭
Emotional_Intelligence_Quotes	情商测试
Fake_Call	假来电
会说话的金杰猫	会说话的金杰猫
Piano_+	钢琴4
梦幻西游	梦幻西游
会说话的汤姆猫	会说话的汤姆猫
doughnut	甜麦圈
Image_Search	图片搜搜
Mega_Photo_Editor	美易照片编辑器
Microphone	微微电话
脑力激荡	脑筋急转弯AI
GoPro	GoPro
美人相机	美颜美人相机
豆瓣阅读	豆瓣阅读
Video_Voice_Changer	视频变声器
Tencent_Video	腾讯视频
Entrepreneurship_Course	创业天下
新浪财经	新浪金融
Stag	Stage
企业微信	企业微信
美妆相机	美妆美颜照相机
Castle_Clash:_ลีกขั้นเทพ	城堡争霸
Inferencia	推求
Family_Farm	家庭农场
Weather_Forecast_for_15_days	天气预报15天
电工	e电工
PowerApp	Power_Apps
Tarot_Divinations	塔罗牌占卜
iGeneration	i代
Waves	浪呀
我的天气_·_MyWeather	我的天气
支付宝	支付宝
上海地铁	上海地铁
Eye4	Eye4
Gun_Simulator	枪支模拟器2
Cheap_Car_Rental	携程租车
HP_Smart	HP_Smart
缤纷碰碰球__-__合并	缤纷碰碰球合并
花样文字	花样文字
小米运动	小米运动
Complete_Medicine_Dictionary	口袋医典
涂鸦智能	涂鸦智能
柬单点	柬单点
MedM_Health	德达康健
WoFit	WoFit
欧姆龙笔记	欧姆龙笔记
Revistas_de_Defensa	国防在线
天天爱烘焙	天天爱烹饪
Haylou_Fit	Haylou_Fit
APlayer	APlayer
Philips_Hue	飞利浦之家
Legend_of_Vikings	王者传奇
Novelas_gratis	免费小说
인생코치	线条教练
宝宝小牧场	宝宝小牧场
Corporate_Finance	企业金融
Maersk_Shipment	Maersk_Shipment
Wayke	万客
朕的江山	朕的江山
Voice_Changer	变音变声器
马卡龙玩图	马卡龙玩图
Cloud_Storage	云店铺
RXCamView	RXCamView
奇妙商场嘉年华	奇妙商场嘉年华
勇闯死人谷_[Into_the_Dead]	勇闯死人谷
Retune	返
Phigolf	Phigolf
Weather_forecast_-_Live_Weather	天气预报-天气
Extreme_Speed	极速
Tenants	任租客
Hello_Neighbor	你好邻居
猎杀巨人的游戏	猎杀巨人的游戏
简拼	简拼
Treasure_Island	闲趣岛
Personal_Fitness_Coach	私人健身教练
YouChat	Yo聊
ГыГы_Приколы	大笑话
睡眠声音	睡眠声音
Sketch_Master	SketchMaster
我的汉克狗	我的汉克狗
机车骑士	机车游侠
魔方	23魔方
时尚小公主	时尚小公主
Piano_master	钢琴演奏大师
Edavilangu_Grama_Panchayat	教育+
Trade_Plus	出行加
Booksy（商家版	约订商家版
Vision+	Vision+
RentCloud_Property_Management	云端物业管理
Vircarda	旋转
通通锁	通通锁
CountDown	倒计时
改变你的声音	变声吧
e-Anatomy	e-Anatomy
手机克隆	手机克隆
Help_Me	帮我吧
时光提醒	时光提醒
网络测速-Test_Network_Speed	网络测速大师
Click_Go	点到
Hand_reading	手阅
快速新闻	快新闻
掌上火车票12306抢票	智行火车票12306抢票
Wearfit_Pro	Wearfit_Pro
Student_Portal	学生港
Zombie_Derby_2	僵尸德比2
Quick_Loans	及速贷款
Smart_Scale	智慧空间
iSmartViewPro	iSmartViewPro
Bind	Bind
快牙网传版	快牙网传
Flash_Chat	闪聊
广州地铁通	广州地铁
体重记录器	体重记录
People's_Daily	人民日报+
Global_Times	Global_Times
Alien_Invasion	异星入侵TD
Millions	亿万
月圆之夜	月圆之夜
English_Listening_and_Speaking	英语听读
Dinside	洞见者
360加密	360加密
Werewolf_Online	狼人Online
Blackboard_-_Magic_Slate	黑板-魔术石板
中华新闻	中华新闻
Make_Friends	20交友
Bridge_Builder	桥梁建造师
奇迹暖暖	奇迹暖暖
Pilot!	Pilot
Okey_-_Platin_Okey	行啊
中文字典	语文词典
Golf_Channel	高尔夫频道
Daily_Readings	每日看书
Pocket_Duas	口袋决斗
宝宝动物启蒙书	宝宝动物启蒙书
万年历	万年历日历
Bay_Area_News	湾区消息
有鱼股票	有鱼股票
完美钢琴	完美钢琴
日语掌中翻译	日语翻译
Bus_Driving_Simulator	公交车驾驶模拟
Genealogy	族记家谱
Screen_Pranks	屏幕恶作剧
Om_Meditation	易冥想
My_Wallet	My钱包
Smart_City	智享城市
green	格林
音乐播放器2020	Music_Player_2019
潮自拍	潮自拍
Highlighter	优看点
宝宝地震安全	宝宝地震安全
极速清理	极速清理
Piano_master	钢琴大师
数独游戏	数独游戏
Color_Lines	彩色连珠
Dyson_Link	Dyson_Link
Massimo_Dutti	Massimo_Dutti
宝宝钓鱼	宝宝钓鱼
GoFIT	GoFIT
Switch手柄Pro	Switch手柄Pro
荒野乱斗	荒野乱斗
Merry_Christmas	欢乐圣诞
Compass	指南针
Perfect_Video_Cutter	完美视频播放器
Notes	小记
High_School_Gang	高中帮
Easy_to_read_Bible	易读圣经
Battle_Star_Arena	战歌竞技场
大众点评	大众点评
KakaFit	KakaFit
Screen_Pranks	屏幕整人恶作剧
Camry_City_Car_Driving_Simulator	汽车城市驾驶模拟器
宝宝巴士世界	宝宝巴士世界
Basketball_World	篮球世界杯
Love_Vs_Marriage	爱优婚恋
YDisciple	分离
LED_LAMP	LED_LAMP
Tank_Battle	坦克大战
Truck_Simulation_19	卡车模拟2018
战魂铭人	战魂铭人
Transport_Manager_Employee_Transport	运车管家员工版
符石守护者	符石守护者
像素生存游戏2	像素生存游戏2
PDF_to_Image_Converter	PDF图片转换器
Bus_Simulator	客车模拟器
智能电视遥控器	智能电视遥控器
DS_audio	DS_audio
Car_maintenance	e养车
E_Wallet	e钱包
Game_Timer	游戏时光
数独世界	数独世界
My_Home	我的Home
Electric_lock_screen	电击屏幕
detikcom_-_Berita_Terbaru_&_Terlengkap	秒吧
中国电视台_(china_tv)	ChinaTV
RavenBattlefield_simulator	战地模拟器
PhotoBook	相片书
微信	微信
美妆相机	美妆相机
Maalaimalar	涂色小画家
Angry_Shark_Sniper_3D	愤怒的鲨鱼狙击手
宝宝牙齿美容	宝宝牙齿美容
Puzzle_Master	拼图高高手
Hungry_Shark_Evolution	饥饿鲨：进化
Mine_World	迷你世界
স্বামী_বিবেকানন্দের_বাণী_-_Swami_Vivekananda_Quote	纸牌游戏之王
汤姆猫英雄跑酷	汤姆猫英雄跑酷
Ophtalmologie	眼视光医生
大师算命馆	大师算命馆
Uperform	升级
Fortune_Telling	算命
Love_Book	恋书
Checkpoint-S	卡点
Daily_Reminders	每日提词
Fishing	出钓
AeroBand	AeroBand
Play!	玩么
Pedometer	计步器
Smart_Meye	智能备忘录
Yuneec_Pilot	Yuneec_Pilot
经济学人·商论	经济学人商论
塔防之王	塔防之王
美人相机	美人相机
Piano_Keyboard	钢琴键盘
Genealogy	族谱
音乐播放器专业版	音乐播放器专业版
抱紧大根的女高中生	抱紧大根的女高中生
双截龙4	双截龙2
公主着装游戏2	公主装扮游戏
Nico	Nico
五子棋	五子棋
360智能摄像机	360智能摄像机
King_of_Avalon	阿瓦隆之王
Smart_Cloud_Storage	智慧云按揭
Dancer	跳跳舞
Mobile_Number_Location_Tracker	手机号定位追踪
游戏录屏大师	游戏录屏大师
尤克里里调音器	尤克里里调音器
誰是臥底	谁是卧底
Hearts_Online	健康在线
火柴人战场	火柴人绝地战场
Storm_Cloud	故事云
百度	百度
云闪付	云闪付
DMarket	地集市
MX_Player_解码包_(ARMv7_NEON)	MX_播放器编解码器（ARMv7_NEON）
Weather_Forecast	天气预报
AliExpress	快售宝
随笔	随笔
ሰላት	Peace
Express_Driver	运销宝司机
HD_Wallpapers	高清壁纸
Water_Live	浪花直播
Metronome	节拍器
Digital_Communication	邮信通
微信读书	微信读书
异乡	异乡
Euskalmet	尺度
5_Minute_Meditation	8分钟冥想
Friends_chat	友缘聊
会说话的汤姆猫2	会说话的汤姆猫2
Drawing_Board	画画板
最美自拍	最美自拍
Psychology	i心理
Tracking	寻迹
截图大师	截屏图片大师
Tap_Metronome_-_节拍器	音乐节拍器-节拍器
Mage_Hero	魔法英雄
World_Football_League	手机足球联盟
Essay_Writing	Easy写作
Cuties	Cutie
链闻	链闻
Clinical_Guidelines	临床指南
永中Office	永中Office
Ant_Family	蚁家人
Manchester_United	曼联
全景生活	全景生活
极速投屏	极速投屏
Tarot_Divinations	塔罗占卜
Dental_Assistant	牙医助理
立即定位	立即定位
Safari_2	猎游
Electronic_Drum_pad	电音鼓垫
光储宝	光储宝
清理大师	清理大师
猎聘	猎聘
Swing	摇摆
二胡调音器	二胡调音器
快速阅读	快读
P6SLite	P6SLite
Aladdin_ALM	阿拉丁APP
香港航空	香港航空
奇妙的怪物朋友	奇妙的怪物朋友
Weather_forecast	天气预通
HAYLOU	HAYLOU
百度地图	百度地图
Mini_Racing_Adventures	迷你赛车冒险
X战机	X战机
Beautiful_Life_Quotes	美好生活家园
Fengshui_Compass	风水罗盘
空战争锋	空战争锋
Qvideo	Qvideo
速卖通卖家	速卖通卖家
会说话的安吉拉	会说话的安吉拉
Spider_Solitaire	蜘蛛纸牌
Sports_info	体育资讯
第二银河	第二银河
Photo_Scanner	照片扫描全能王
Smart_Life	Smart_Life
Project_Management	项目管理
我的汤姆猫2	我的汤姆猫2
智能计算器	智能计算器
Frases_de_bendiciones	祝福语
DJ多多	DJ多多
海南航空	海南航空
Drink_Master	喝水吧
Baby_Nursery_Rhymes	宝宝童谣
火柴人越狱	火柴人越狱
Ask_Me	AskMe
Octopus	大章鱼
UpToDate	UpToDate
Business_Insurance_Online	阳光保险在线
ClassIn	ClassIn
微软桌面	微软桌面
腿锻炼锻炼	腿部锻炼
Daýhandan	热爱
模拟人生™：畅玩版	模拟人生：畅玩版
FM_收音机	FM电台收音机
智能证件照	智能证件照
唐诗三百首	唐诗三百首
奇妙的动物家庭	奇妙的动物家庭
Humorous_Quotes	幽默笑话
Best_Sniper:_Shooting_Hunter	最佳狙击手：射击猎人3D
深圳地铁通	深圳地铁
Debate_Assistant	节拍助手
Explorer	Explore
Art_Of_War	战争艺术
The_League	王牌联盟
Sleep	睡觉
Artificial_Intelligence	人工智能考试
倚天屠龍記	倚天屠龙记
钉钉	钉钉
Voice_Assistant	语音小助手
微读圣经	微读圣经
真人欢乐捕鱼	真人欢乐捕鱼
Anime_Avatar_Maker	动漫头像制作器
Screen_Recorder	录屏师
Puzzler	拼图
开眼	开眼
Fantasy_Wallpapers	幻彩壁纸
婴儿乐器	宝宝乐器
Livescore	实况比分
企鹅FM	企鹅FM
kheti_dekho	Select
晴天小狗2	晴天小狗
Hello_Doctor	Hello_Doctor
海盗：加勒比海亨特	海盗：加勒比海亨特
密室逃脱：挑战100个房间八	密室逃脱：挑战100个房间
Cloud_Church	云教会
中国新闻	ChinaNews
Builder_CRM	筑成CRM
DJI_Fly	DJI_Fly
News_Flash	新闻快讯
星座运势	星座运势
Panda_Express	熊猫速汇
Inglés_de_negocios_gratis	商务英语口语
Chess_Game	象棋对弈
Kütüphanem	藏书馆
Organic_Farming	有机农庄
Project_Fuse	缪斯计划
魔方	58魔方
Save_money	花钱省
P图神器	P图神器
Car_Escape	汽车大逃杀
BigDish_Merchant	大鱼商家
亿连驾驶助手	亿连驾驶助手
银河袭击：独立行动	银河袭击独立行动
Building_Materials	建材猫
Guns_and_Spurs_2	火枪与马刺
V380_Pro	V380_Pro
Alchemy	炼金术
中国国航	中国国航
