智能生活	智能生活
指尖陀螺	Fidget_Spinner
宝宝运动会	宝宝运动会
腹部锻炼	腹部锻炼
PICOOC	PICOOC
动态壁纸	3D_动态壁纸
二战风云	二战风云
滴答节拍器-节拍器	Tap_Metronome_-_节拍器
阿瑞斯病毒	阿瑞斯病毒
手机搬家	手机搬家
吾记日记	My_Diary
预产期计算器	Due_Date_Calculator
火柴人英雄战场	火柴人战场
QQ邮箱	QQ邮箱
Manga_Clash_-_Warrior_Arena	Manga_Clash_-_Warrior_Arena
宝宝台风天气	宝宝台风天气
7分钟锻炼	7分钟锻炼免费
街头篮球	街头篮球
项目经理	Project_Manager
荒野战斗宝箱模拟器	荒野战斗宝箱模拟器
漫威：超级争霸战	漫威:_超级争霸战
个人简历制作	简历创建者
羽毛球高高手	羽毛球高高手
动漫卡通头像制作	动漫_装扮_头像制作
国泰航空	国泰航空
快读书	快速阅读
停站竞赛：经纪人	停站竞赛_:_经纪人
Photo_Editor	Photo_Editor
成长帝国：罗马	发展帝国：罗马_(Grow_Empire:_Rome)
简易便签	简单的笔记
照片编辑器	Photo_Editor
奇妙美味日记	奇妙美味日记
录屏	屏幕录像机
我的勇者	我的勇者
微博国际版	微博国际版
米家	米家
迅游手游加速器	迅游手游加速器
抑郁症测试	抑郁症测试
照顾小宝宝	照顾小宝宝
全国实时天气	全球实时天气
合力救援	合力救援
速新闻	快速新闻
拍库	Photo_Gallery
HP_打印服务插件	HP_Print_Service_插件
通讯录+	通讯录
名人站	名人站
万豪旅享家	万豪旅享家
幸运符	幸運符
澳觅	澳覓
今日头条	今日头条
魔漫相机	魔漫相机
汇丰银行	汇丰银行
TouchRetouch	TouchRetouch
变形金刚：百炼为战	变形金刚：百炼为战
倒放挑战HQ	倒放挑战
中医家	中医方剂
见缝插针	见缝插针
义乌购	义乌购
淘宝特价版	淘宝特价版
全能视频下载器	全能视频下载器
铁友火车票12306抢票	掌上火车票12306抢票
国际跳棋	国际跳棋游戏
Snapseed	Snapseed
男性家庭锻炼	男性家庭锻炼
僵尸尖叫	Zombie_Tsunami_(僵尸尖叫)
便签本	Notepad
FM收音机广播	电台广播
每周计划	每周的日程计划
音频编辑器	Auphonic_Edit
猜猜这是谁	猜猜看
围棋	围棋
指南针罗盘	Compass
SleepTown	SleepTown_睡眠小镇
二维码生成器	二维码生成器
Fitbit	Fitbit
国家地理	National_Geographic_DE
微博	微博
浪荡天涯	浪荡天涯
天气预报王	天气预报小部件
尺子测距仪	测距仪
有我看家	有我看家
PDF_效用	PDF_效用
宝宝果汁商店	宝宝果汁商店
迅雷手游加速器	迅游手游加速器
DISC_LINK_Platinum	DISC_LINK_Platinum
宝宝交通工具书	宝宝交通工具书
奇妙怪物美容	奇妙怪物美容
过山车模拟器	过山车火车模拟器
汤姆猫的摩托艇	汤姆猫的摩托艇_2
减肥食谱	减肥食谱
终极狐狸模拟器	Ultimate_Fox_Simulator
一嗨租车	一嗨租车
新浪财经	新浪财经
阴阳师:百闻牌	陰陽師：百聞牌
新浪新闻	新浪新闻
猫里奥	猫里奥
战舰世界闪击战	战舰世界闪击战
真心话大冒险	真心话大冒险
分贝仪	分贝计
薄荷记账	薄荷记账
白噪音	White_Noise
Agoda安可达	安可达_(Agoda)
汤姆猫跑酷	汤姆猫跑酷
声波清理大师	声波清理大师
企鹅电竞直播助手	企鹅电竞直播助手
相机360	相机360
屏幕录像	屏幕录像机
模拟农场16	模拟农场
ChinaRadio	美国中文电台_美国中文收音机_全球多国_华语电台_US_Chinese_Radio
银河大战	银河大战
Coremail论客	Coremail论客
奇妙咖啡餐厅	奇妙咖啡餐厅
象棋	象棋
我在大清当皇帝	我在大清當皇帝
随身乐队	随身乐队
拼多多	拼多多
黑洞大作战	黑洞大作战
私密浏览器	Private_Browser
钢之黎明	Dawn_of_Steel
如丽整形	Body_Plastic_Surgery
柬埔寨头条	柬埔寨头条
讯飞输入法	讯飞输入法
都都数学	都都数学
大提琴调音器	大提琴调音器
宝宝巴士习惯班	宝宝巴士习惯班
确幸股票	Lucky_Block
超级海星	超级星鱼
护眼大师	护眼滤镜
间隔计时器	Interval_Timer
卡通射手2：自由职业者	卡通射手2:_自由职业者
宝宝学数字	宝宝学数字
向日葵远程控制	向日葵远程控制
在你身后	在你身后！
儿童学英语	小孩学英语
趣铃声	搞怪铃声
图片编辑器	图片编辑器
物理小球	物理弹球
有型型男专属自拍相机	有型_-_型男专属自拍相机
要塞围城	要塞围城
疯狂阅读	疯狂赛车
Persian_Calendar	期间日历
挑战巅峰	挑战巅峰
拳皇命运	拳皇命運
最强蜗牛	最強蝸牛
30天练出六块腹肌	在_30_天内练就六块腹肌
华夏地理	National_Geographic_DE
飞行棋	飞行棋
英语电台FM收音机	英语电台FM收音机
微家居资讯	微软资讯
芭比梦幻屋冒险	Barbie_Dreamhouse_Adventures
FM收音机	FM_收音机
鼓点节拍器-节拍器	Tap_Metronome_-_节拍器
语音转文字	语音转文字
1byone_Health	1byone_Health
建工计算器	Construction_Calculator
赚钱帮	赚钱博客
街机达人捕鱼	街機達人捕魚
Zenly:_你的专属地图，你的伙伴们	Zenly：你的专属地图，你的伙伴们
特技水运	特技水运
小验一下	トゥギャッター_/_話題のネタやニュースをまとめてチェック！
简历	个人简历
政务微信	政务微信
泡泡魔女传奇3	泡泡魔女传奇3
佛教音乐-大悲咒	大悲咒佛教音乐
漫威无限	Marvel_Unlimited
截图工具	截图工具
东亚银行	BEA_東亞銀行
分动	分动
搜狐资讯	The_Information
有鱼智投	有鱼智投
心诚则灵	心诚则灵
贪吃蛇进化论	貪吃蛇進化論
各种各样的人	各种各样的人
Stream_Vision	Stream_Vision
WearFit2.0	WearFit2.0
千炮疯狂捕鱼	千炮达人捕鱼
Huion_Sketch	Huion_Sketch
极限着陆	极限着陆
智家365	智家365
炸弹小分队	炸弹小分队
小小矿工	小小矿工
MX_播放器	MX_Player
闪耀暖暖	閃耀暖暖
凤凰新闻	凤凰新闻
探索雅星会	探索雅星会
数独	Sudoku
烘焙食谱	Baking_Recipes
买建材	建筑材料
立方大冒险	Nubs'_Adventure
我的汤姆猫	我的汤姆猫2
脑筋急转弯	脑力激荡
反恐死亡射击	反恐死亡射击
地铁跑酷	Subway_Surfers
世界地图	世界地图！
战斗之心	Battleheart
21相机	21相机
Splash	Splash（流光溢彩）
WiFi万能钥匙	WiFi万能钥匙
拓课云Plus	拓课云Plus
先锋视频播放器	影音先锋_-_播放器
厚墨	厚墨
梦境侦探	梦境侦探
会说话的狗2	会说话的狗AR
海贝音乐	海贝音乐
冥想音乐	冥想音乐
汇率换算	Currency_Converter
驾驶学校2016	Driving_School_2016
模拟炒股	Stock_Market_Simulator
箱中少女	箱中少女
名侦探老王	名侦探老王
宝宝爱整理	宝宝爱整理
药水制作师	药水制作师
生日提醒管家	生日提醒警报
泡泡射手	Bubble_Shooter
沙盒	沙盒
神秘之城：寻物历险	神秘之城:_寻物历险
Siterlink	Slitherlink
动漫壁纸	Anime_Wallpaper
时光日记	时光日记
QQ音乐	QQ音乐
宝宝地震安全2	宝宝地震安全2
南洋商业银行	南洋商业银行
我们之中	Among_Us
藝弘_ArtHola	藝宏_ArtHola
模拟农场20	模拟农场
不可能的BMX自行车特技	Impossible_Bike_Stunts
宝宝巴士数学冒险	宝宝巴士数学冒险
枪支俱乐部	Gun_Club_2
万年历	万年历
照片水印	照片水印
30_天內减肥	30天内减肥
招商永隆一点通	招商永隆一点通
青青日记	青青日记
女性健身-女性锻炼	女性健身_-_女性锻炼
精读圣经	精读圣经
懒饭	懒饭
会说话的金杰猫	会说话的金杰猫
钢琴4	Piano_+
梦幻西游	梦幻西游
会说话的汤姆猫	会说话的汤姆猫
图片搜搜	Image_Search
脑筋急转弯AI	脑力激荡
GoPro	GoPro
美颜美人相机	美人相机
豆瓣阅读	豆瓣阅读
腾讯视频	Tencent_Video
新浪金融	新浪财经
企业微信	企业微信
美妆美颜照相机	美妆相机
e电工	电工
我的天气	我的天气_·_MyWeather
支付宝	支付宝
上海地铁	上海地铁
HP_Smart	HP_Smart
缤纷碰碰球合并	缤纷碰碰球__-__合并
花样文字	花样文字
小米运动	小米运动
涂鸦智能	涂鸦智能
柬单点	柬单点
德达康健	MedM_Health
WoFit	WoFit
欧姆龙笔记	欧姆龙笔记
天天爱烹饪	天天爱烘焙
APlayer	APlayer
宝宝小牧场	宝宝小牧场
Maersk_Shipment	Maersk_Shipment
朕的江山	朕的江山
马卡龙玩图	马卡龙玩图
奇妙商场嘉年华	奇妙商场嘉年华
勇闯死人谷	勇闯死人谷_[Into_the_Dead]
你好邻居	Hello_Neighbor
猎杀巨人的游戏	猎杀巨人的游戏
简拼	简拼
私人健身教练	Personal_Fitness_Coach
睡眠声音	睡眠声音
SketchMaster	Sketch_Master
我的汉克狗	我的汉克狗
机车游侠	机车骑士
23魔方	魔方
时尚小公主	时尚小公主
约订商家版	Booksy（商家版
通通锁	通通锁
变声吧	改变你的声音
手机克隆	手机克隆
时光提醒	时光提醒
网络测速大师	网络测速-Test_Network_Speed
快新闻	快速新闻
智行火车票12306抢票	掌上火车票12306抢票
快牙网传	快牙网传版
广州地铁	广州地铁通
体重记录	体重记录器
月圆之夜	月圆之夜
英语听读	English_Listening_and_Speaking
360加密	360加密
狼人Online	Werewolf_Online
中华新闻	中华新闻
奇迹暖暖	奇迹暖暖
语文词典	中文字典
宝宝动物启蒙书	宝宝动物启蒙书
万年历日历	万年历
有鱼股票	有鱼股票
完美钢琴	完美钢琴
日语翻译	日语掌中翻译
Music_Player_2019	音乐播放器2020
潮自拍	潮自拍
宝宝地震安全	宝宝地震安全
极速清理	极速清理
数独游戏	数独游戏
Massimo_Dutti	Massimo_Dutti
宝宝钓鱼	宝宝钓鱼
Switch手柄Pro	Switch手柄Pro
荒野乱斗	荒野乱斗
指南针	Compass
小记	Notes
大众点评	大众点评
宝宝巴士世界	宝宝巴士世界
战魂铭人	战魂铭人
符石守护者	符石守护者
像素生存游戏2	像素生存游戏2
PDF图片转换器	PDF_to_Image_Converter
智能电视遥控器	智能电视遥控器
数独世界	数独世界
ChinaTV	中国电视台_(china_tv)
微信	微信
美妆相机	美妆相机
宝宝牙齿美容	宝宝牙齿美容
汤姆猫英雄跑酷	汤姆猫英雄跑酷
大师算命馆	大师算命馆
恋书	Love_Book
计步器	Pedometer
经济学人商论	经济学人·商论
塔防之王	塔防之王
美人相机	美人相机
音乐播放器专业版	音乐播放器专业版
抱紧大根的女高中生	抱紧大根的女高中生
双截龙2	双截龙4
公主装扮游戏	公主着装游戏2
五子棋	五子棋
360智能摄像机	360智能摄像机
游戏录屏大师	游戏录屏大师
尤克里里调音器	尤克里里调音器
谁是卧底	誰是臥底
火柴人绝地战场	火柴人战场
百度	百度
云闪付	云闪付
MX_播放器编解码器（ARMv7_NEON）	MX_Player_解码包_(ARMv7_NEON)
快售宝	AliExpress
随笔	随笔
高清壁纸	HD_Wallpapers
节拍器	Metronome
微信读书	微信读书
异乡	异乡
会说话的汤姆猫2	会说话的汤姆猫2
最美自拍	最美自拍
i心理	Psychology
截屏图片大师	截图大师
音乐节拍器-节拍器	Tap_Metronome_-_节拍器
链闻	链闻
永中Office	永中Office
全景生活	全景生活
极速投屏	极速投屏
立即定位	立即定位
光储宝	光储宝
清理大师	清理大师
猎聘	猎聘
二胡调音器	二胡调音器
快读	快速阅读
香港航空	香港航空
奇妙的怪物朋友	奇妙的怪物朋友
天气预通	Weather_forecast
百度地图	百度地图
X战机	X战机
美好生活家园	Beautiful_Life_Quotes
空战争锋	空战争锋
速卖通卖家	速卖通卖家
会说话的安吉拉	会说话的安吉拉
蜘蛛纸牌	Spider_Solitaire
第二银河	第二银河
我的汤姆猫2	我的汤姆猫2
智能计算器	智能计算器
DJ多多	DJ多多
海南航空	海南航空
火柴人越狱	火柴人越狱
微软桌面	微软桌面
腿部锻炼	腿锻炼锻炼
模拟人生：畅玩版	模拟人生™：畅玩版
FM电台收音机	FM_收音机
智能证件照	智能证件照
唐诗三百首	唐诗三百首
奇妙的动物家庭	奇妙的动物家庭
深圳地铁	深圳地铁通
Explore	Explorer
倚天屠龙记	倚天屠龍記
钉钉	钉钉
微读圣经	微读圣经
真人欢乐捕鱼	真人欢乐捕鱼
录屏师	Screen_Recorder
开眼	开眼
宝宝乐器	婴儿乐器
企鹅FM	企鹅FM
晴天小狗	晴天小狗2
海盗：加勒比海亨特	海盗：加勒比海亨特
密室逃脱：挑战100个房间	密室逃脱：挑战100个房间八
ChinaNews	中国新闻
DJI_Fly	DJI_Fly
星座运势	星座运势
58魔方	魔方
P图神器	P图神器
汽车大逃杀	Car_Escape
亿连驾驶助手	亿连驾驶助手
银河袭击独立行动	银河袭击：独立行动
V380_Pro	V380_Pro
中国国航	中国国航
