NAKAYUBI_CORPORATION	NAKAYUBI_CORPORATION
Christmas_FM	Christmas_FM
Instagram	Instagram
和Smart-Teacher一起学习美国英语单词	和Smart-Teacher一起学习美国英语单词
SET_Application	SET_Application
CHOMP_by_Christoph_Niemann	CHOMP_by_Christoph_Niemann
牙医也疯狂	牙医也疯狂
LiveABC	LiveABC
摇滚音乐电台	摇滚音乐电台
Web_Prancer	Web_Prancer
着色像素8x8	着色像素8x8
UNdata	UNdata
Learn_Top_300_German_Words	Learn_Top_300_German_Words
考拉粉碎	考拉粉碎
Bitwarden_密码管理器	Bitwarden_密码管理器
Fubon_Bank_(Hong_Kong)_Limited	Fubon_Bank_(Hong_Kong)_Limited
的经期跟踪：月经和生育日历,_排卵期计算器	的经期跟踪：月经和生育日历,_排卵期计算器
TimeTree,_Inc.	TimeTree,_Inc.
Link_File_Share：通过链接发送	Link_File_Share：通过链接发送
Image_Sync	Image_Sync
Weebly,_Inc.	Weebly,_Inc.
何时钓鱼	何时钓鱼
Naohito_Muraoka	Naohito_Muraoka
Thumbnail_Maker	Thumbnail_Maker
Dmytro_Hrebeniuk	Dmytro_Hrebeniuk
Oddrobo_Software_AB	Oddrobo_Software_AB
Vs時尚_:_挑選屬於你的時尚	Vs時尚_:_挑選屬於你的時尚
monois_Inc.	monois_Inc.
United_Nations_Visitor_Centre	United_Nations_Visitor_Centre
超级PDF文件扫描仪	超级PDF文件扫描仪
乘法表智商	乘法表智商
Simpler_Apps_Inc	Simpler_Apps_Inc
LEAF_智慧社区	LEAF_智慧社区
Yoga_Buddhi_Co.	Yoga_Buddhi_Co.
大头斗兽棋	大头斗兽棋
Jazz_Radio	Jazz_Radio
Hugs_N_Hearts	Hugs_N_Hearts
Andrey_Banshchikov	Andrey_Banshchikov
The_Hongkong_and_Shanghai_Banking_Corporation_Ltd	The_Hongkong_and_Shanghai_Banking_Corporation_Ltd
CALURA_LTD.	CALURA_LTD.
Global_Blue_Marketing_Services_Ltd	Global_Blue_Marketing_Services_Ltd
PCHOMESTORE_INC.	PCHOMESTORE_INC.
PESHUB_21_Unofficial	PESHUB_21_Unofficial
GD-CRM_小幫手	GD-CRM_小幫手
虚拟生活_-_生活模拟游戏_第二人生	虚拟生活_-_生活模拟游戏_第二人生
Lithium_Lab_Pte_Ltd	Lithium_Lab_Pte_Ltd
Microsoft_Corporation	Microsoft_Corporation
AppAspect_Technologies_Pvt._Ltd.	AppAspect_Technologies_Pvt._Ltd.
Ohayoo	Ohayoo
Visible_Body	Visible_Body
Chiyu_Banking_Corporation_Limited	Chiyu_Banking_Corporation_Limited
RaceCraft_-_搭建与赛车	RaceCraft_-_搭建与赛车
Immediate_Contact_Transfer	Immediate_Contact_Transfer
Nepali_Keyboard	Nepali_Keyboard
DOKDOAPPS	DOKDOAPPS
English_Grammar	English_Grammar
SHIGETO_TAKAGI	SHIGETO_TAKAGI
HARAPECORPORATION_Inc.	HARAPECORPORATION_Inc.
Eiko_Morozumi	Eiko_Morozumi
Google_翻译	Google_翻译
Onet_Deluxe	Onet_Deluxe
V1_Golf	V1_Golf
Japan_News	Japan_News
RosiMosi_LLC	RosiMosi_LLC
Tutor_del_ECG_Ritmo	Tutor_del_ECG_Ritmo
Zoho_Corporation	Zoho_Corporation
YI_ZHENG	YI_ZHENG
Digital_Classifieds_Group_Pty_Ltd	Digital_Classifieds_Group_Pty_Ltd
Wawwo	Wawwo
FlagFit	FlagFit
AfterShip_Limited	AfterShip_Limited
Easy_Wallet_悠遊付	Easy_Wallet_悠遊付
旅行计算器	旅行计算器
即视通	即视通
NFO_LTD	NFO_LTD
7th_Gear	7th_Gear
Lipa_Learning	Lipa_Learning
AFOX_TEC	AFOX_TEC
Avatar_Maker:_Anime_Selfie	Avatar_Maker:_Anime_Selfie
Hubei_Kabocha_Network_Technology_Co.,_Ltd.	Hubei_Kabocha_Network_Technology_Co.,_Ltd.
Maxime_Maisonneuve	Maxime_Maisonneuve
Skyjos_Co.,_Ltd.	Skyjos_Co.,_Ltd.
Igoox	Igoox
HSBC_Singapore	HSBC_Singapore
长诚汇款	长诚汇款
Azur_Interactive_Games_Limited	Azur_Interactive_Games_Limited
Sony_|_Music_Center	Sony_|_Music_Center
Kinetic_Bytes	Kinetic_Bytes
Petand_Technologies	Petand_Technologies
IPVideoTalk	IPVideoTalk
School_Team_Technology_Limited	School_Team_Technology_Limited
警车驾驶模拟器	警车驾驶模拟器
Freshservice	Freshservice
Infinite_Financial_Solutions_Limited	Infinite_Financial_Solutions_Limited
Sophos_Secure_Workspace	Sophos_Secure_Workspace
山警察对匪徒追逐	山警察对匪徒追逐
经文雨_－_好玩又有效的背圣经经文游戏！	经文雨_－_好玩又有效的背圣经经文游戏！
ATi_Studios	ATi_Studios
UVLens_-_紫外线指数监测器	UVLens_-_紫外线指数监测器
Craigpark_Limited	Craigpark_Limited
WhiteBoard	WhiteBoard
Solocator_-_GPS_Field_Camera	Solocator_-_GPS_Field_Camera
Dropbox,_Inc.	Dropbox,_Inc.
SOQI一起go	SOQI一起go
Banana.ch_SA	Banana.ch_SA
Bo_Kalvslund	Bo_Kalvslund
Simya_Solutions_Ltd.	Simya_Solutions_Ltd.
Deutsche_Lufthansa_AG	Deutsche_Lufthansa_AG
Socialpoint	Socialpoint
MP3提取转换器	MP3提取转换器
German_Verb_Conjugator	German_Verb_Conjugator
Amber_Mobile_Limited	Amber_Mobile_Limited
VGFIT_LLC	VGFIT_LLC
Gulf_Air	Gulf_Air
水提醒_-_Water_Reminder	水提醒_-_Water_Reminder
Scientific_Calculator_Pro	Scientific_Calculator_Pro
Sumi_Interactive	Sumi_Interactive
高速铁路	高速铁路
KY_FPV	KY_FPV
Swissquote	Swissquote
Memorize_Quran	Memorize_Quran
Kids_Fun_Plus	Kids_Fun_Plus
智能背景橡皮擦_-_自动抠图_-_AI去背工具	智能背景橡皮擦_-_自动抠图_-_AI去背工具
帐簿	帐簿
卢浮宫聊天机器人指南	卢浮宫聊天机器人指南
Desygner_Pty_Ltd	Desygner_Pty_Ltd
Tattoo_my_Photo_2.0	Tattoo_my_Photo_2.0
SeTracker	SeTracker
Khada_-_3D_Viewer_for_LoL	Khada_-_3D_Viewer_for_LoL
Meywo_s.r.o.	Meywo_s.r.o.
LINE_Corporation	LINE_Corporation
音频转换器	音频转换器
DreamSky	DreamSky
BEEP_-_有效期管理	BEEP_-_有效期管理
Oh_My_Doll_-_Avatar_Creator	Oh_My_Doll_-_Avatar_Creator
Drivvo_-_车辆管理	Drivvo_-_车辆管理
发光_-_绘画为孩子	发光_-_绘画为孩子
Flick_Kick_Rugby_Kickoff	Flick_Kick_Rugby_Kickoff
经度与纬度	经度与纬度
托马斯和朋友：魔幻铁路	托马斯和朋友：魔幻铁路
English_News_in_Levels	English_News_in_Levels
捷星	捷星
汇丰私人银行香港	汇丰私人银行香港
Mindware_Consulting,_Inc	Mindware_Consulting,_Inc
Jewelsapps_S._L.	Jewelsapps_S._L.
Baby_Pics	Baby_Pics
CCApp	CCApp
PChome商店街	PChome商店街
Pierluigi_Solimena	Pierluigi_Solimena
无所畏惧的BMX_Rider_2019	无所畏惧的BMX_Rider_2019
战魂铭人	战魂铭人
Kalrom_Systems_LTD	Kalrom_Systems_LTD
Allm_Inc.	Allm_Inc.
Daily_Workout_Apps,_LLC	Daily_Workout_Apps,_LLC
Eturi_Corp.	Eturi_Corp.
ElitSolutions.com	ElitSolutions.com
企业微信	企业微信
Disneyland®	Disneyland®
Space_Corgi_(太空旅行的小狗)	Space_Corgi_(太空旅行的小狗)
Thai_Airways	Thai_Airways
落字游戏	落字游戏
Weebly_通过_Square	Weebly_通过_Square
围棋_-_2位玩家	围棋_-_2位玩家
Fusion_360	Fusion_360
Komorebi_Inc.	Komorebi_Inc.
30天减肥	30天减肥
做饭游戏-美食甜甜圈	做饭游戏-美食甜甜圈
BGPworks	BGPworks
NHN_Corp.	NHN_Corp.
GIF转视频	GIF转视频
Revontulet_Soft_Inc	Revontulet_Soft_Inc
Raw_Fury	Raw_Fury
联合国与非政府组织工作	联合国与非政府组织工作
RTHK_News	RTHK_News
Wombat_Studio,_Inc.	Wombat_Studio,_Inc.
CardioSmart_Heart_Explorer	CardioSmart_Heart_Explorer
Ketchapp	Ketchapp
Get_Geo-Coordinates	Get_Geo-Coordinates
治愈的鹦鹉育成游戏	治愈的鹦鹉育成游戏
PopReach_Incorporated	PopReach_Incorporated
麻将	麻将
北京地铁地图_(Explore_Beijing)	北京地铁地图_(Explore_Beijing)
HP_Inc.	HP_Inc.
Neutron_Music_Player	Neutron_Music_Player
Promega_Biomath_Calculators	Promega_Biomath_Calculators
SUD_Inc.	SUD_Inc.
Dwell:_Audio_Bible	Dwell:_Audio_Bible
Pacsquare_Technologies	Pacsquare_Technologies
古典音乐铃声免费	古典音乐铃声免费
Simple_Calculator	Simple_Calculator
捕鱼节	捕鱼节
烤面包的女孩	烤面包的女孩
hap_Inc.	hap_Inc.
Hammad_Ali	Hammad_Ali
Bank_of_China_(Hong_Kong)_Limited	Bank_of_China_(Hong_Kong)_Limited
Norbu_藏历每日运程与日历	Norbu_藏历每日运程与日历
30天内练出六块腹肌_-_腹肌锻炼	30天内练出六块腹肌_-_腹肌锻炼
Password_Manager	Password_Manager
Goal_Live_Scores	Goal_Live_Scores
Funding_Societies	Funding_Societies
WomanLog_宝宝日历	WomanLog_宝宝日历
Miroslav_Capkovic	Miroslav_Capkovic
星食客_-_新加坡全岛中餐外卖	星食客_-_新加坡全岛中餐外卖
Cheap_Flights_Tickets	Cheap_Flights_Tickets
Kosuke_Hamada	Kosuke_Hamada
Fingersoft	Fingersoft
SayMoney_-_您的财务	SayMoney_-_您的财务
Period_and_Ovulation_Tracker	Period_and_Ovulation_Tracker
逃离公司3	逃离公司3
儿童教育游戏_4	儿童教育游戏_4
Google_日历	Google_日历
Makuake,_Inc.	Makuake,_Inc.
SAASPASS	SAASPASS
English_Irregular_Verbs	English_Irregular_Verbs
Olis_Innovation_Co.	Olis_Innovation_Co.
MTR_Corporation_Limited	MTR_Corporation_Limited
学印尼文_-_常用印尼语会话短句及生字_|_印尼文翻译器	学印尼文_-_常用印尼语会话短句及生字_|_印尼文翻译器
Home_Network	Home_Network
cocolo-bit_Inc.	cocolo-bit_Inc.
Go_To_Travel_Guides	Go_To_Travel_Guides
GUCCI	GUCCI
Learn_Italian_for_Beginners	Learn_Italian_for_Beginners
Loop_Maker_Pro_-_音乐创作者	Loop_Maker_Pro_-_音乐创作者
汤姆猫跑酷	汤姆猫跑酷
SOFTSEED_Inc.	SOFTSEED_Inc.
OverDrive,_Inc.	OverDrive,_Inc.
Erudite	Erudite
Changing_Information_Technology_Inc.	Changing_Information_Technology_Inc.
Social_Impact_Inc.	Social_Impact_Inc.
TENDY_Taiwan_Corporation._,_Ltd.	TENDY_Taiwan_Corporation._,_Ltd.
Zoe:_女同性恋约会和交友软件	Zoe:_女同性恋约会和交友软件
我的极光预报_-_极光提醒·北极光	我的极光预报_-_极光提醒·北极光
appChocolate	appChocolate
OGQ	OGQ
香港航空	香港航空
怀孕计算器	怀孕计算器
USAYA_Co.,_Ltd.	USAYA_Co.,_Ltd.
TONKA：城镇卡车	TONKA：城镇卡车
LePolka優質美學時尚穿搭	LePolka優質美學時尚穿搭
RockCat_Studio_Limited	RockCat_Studio_Limited
Extracomm_Inc.	Extracomm_Inc.
猫咪玩具(猫喜爱的声音与游戏)	猫咪玩具(猫喜爱的声音与游戏)
Fun_Games_For_Free	Fun_Games_For_Free
Intel_Corporation	Intel_Corporation
JoyTunes	JoyTunes
Andrey_Solovyev	Andrey_Solovyev
Bibi_恐龙_学习游戏_-_适合2-5岁儿童	Bibi_恐龙_学习游戏_-_适合2-5岁儿童
Signum_International_AG	Signum_International_AG
日记本_–_带密码的日记本	日记本_–_带密码的日记本
学德文_-_常用德语会话短句及生字_|_德文翻译器	学德文_-_常用德语会话短句及生字_|_德文翻译器
PLAYTOUCH	PLAYTOUCH
地震讯息	地震讯息
Facebook	Facebook
NHK_WORLD-JAPAN	NHK_WORLD-JAPAN
Windigig	Windigig
Pearson_Education_Asia_Limited	Pearson_Education_Asia_Limited
DAN-BALL	DAN-BALL
Orthodox_Church_in_Hong_Kong_香港聖彼得聖保羅東正教堂	Orthodox_Church_in_Hong_Kong_香港聖彼得聖保羅東正教堂
BeVoid_Limited	BeVoid_Limited
照片小部件	照片小部件
完美钢琴	完美钢琴
CHILL_自創女裝品牌	CHILL_自創女裝品牌
越野Hilux皮卡车驾驶模拟器	越野Hilux皮卡车驾驶模拟器
P6SPro	P6SPro
Hello_Kitty_时尚之星	Hello_Kitty_时尚之星
晚安卡由	晚安卡由
Vyacheslav_Petrukhin	Vyacheslav_Petrukhin
Zinkia_Entertainment,_S.A.	Zinkia_Entertainment,_S.A.
Smart_Magnifier	Smart_Magnifier
Rendered_Ideas	Rendered_Ideas
Udemy	Udemy
TOTAL_IELTS_Listening_Practice	TOTAL_IELTS_Listening_Practice
CronlyGames_Inc.	CronlyGames_Inc.
FlagFit_2.0	FlagFit_2.0
数学|谜题和益智数学游戏	数学|谜题和益智数学游戏
Stack3	Stack3
DrawExpress_Diagram_Lite	DrawExpress_Diagram_Lite
CAD_Assistant	CAD_Assistant
91APP,_Inc.	91APP,_Inc.
Rayark_International_Limited	Rayark_International_Limited
Electric_French_Fries	Electric_French_Fries
LOBBY韓系平價女裝	LOBBY韓系平價女裝
《西部狙击手：狂野西部》FPS射击游戏	《西部狙击手：狂野西部》FPS射击游戏
Pi_Mobile_Technology_Inc.	Pi_Mobile_Technology_Inc.
App_Diggity,_LLC	App_Diggity,_LLC
导师箱	导师箱
上海地铁通	上海地铁通
HTC_Corporation	HTC_Corporation
MetaQuotes_Software_Corp.	MetaQuotes_Software_Corp.
HENN_Inc.	HENN_Inc.
Kurechii	Kurechii
ExploreMetro	ExploreMetro
机器人_虚拟拳击3D	机器人_虚拟拳击3D
FARBEYOND_LLC	FARBEYOND_LLC
宝宝活动全记录	宝宝活动全记录
Pano_Tuner_-_Chromatic_Tuner	Pano_Tuner_-_Chromatic_Tuner
色環_RYB_CMYK_RGB	色環_RYB_CMYK_RGB
轮班工作日历	轮班工作日历
化学结构小测验	化学结构小测验
My_Package_Tracking	My_Package_Tracking
Gismart	Gismart
Artify_Inc.	Artify_Inc.
动物之森_-_袖珍指南	动物之森_-_袖珍指南
ASUS_AiCloud	ASUS_AiCloud
HP_Smart	HP_Smart
Ice_Cold_Apps	Ice_Cold_Apps
奇妙的机械_-_Tinybop出品	奇妙的机械_-_Tinybop出品
华为企业服务	华为企业服务
Evgenii_Viushkov	Evgenii_Viushkov
Playnote_Limited	Playnote_Limited
翻译	翻译
Dmitry_Zaika	Dmitry_Zaika
TutoTOONS	TutoTOONS
Newkline_Co.,_Ltd.	Newkline_Co.,_Ltd.
Tatsuki	Tatsuki
Owly_Labs	Owly_Labs
Tsuyoshi_Niwa	Tsuyoshi_Niwa
國際象棋达人	國際象棋达人
婚礼相框	婚礼相框
物理弹球	物理弹球
Nero_AG	Nero_AG
中国新闻	中国新闻
Best_Night_Light	Best_Night_Light
Auto_Repair_and_Service_Group_Limited	Auto_Repair_and_Service_Group_Limited
VIVILIAN薇薇莉安日系服飾	VIVILIAN薇薇莉安日系服飾
Jason_Attard	Jason_Attard
Foreca_Weather	Foreca_Weather
Yuriy_Kvasha	Yuriy_Kvasha
Movie_Edit_add-on	Movie_Edit_add-on
LETS_Limited	LETS_Limited
Koreatop韓物通	Koreatop韓物通
HKTDC_Marketplace	HKTDC_Marketplace
Nickelodeon	Nickelodeon
Strategic_IQ	Strategic_IQ
ATV_亞洲電視	ATV_亞洲電視
Autodesk_Inc.	Autodesk_Inc.
心率	心率
Hot_Wheels_Unlimited	Hot_Wheels_Unlimited
WeDate	WeDate
Robert_Bosch_Power_Tools_GmbH	Robert_Bosch_Power_Tools_GmbH
App_Holdings	App_Holdings
redgood	redgood
Snapseed	Snapseed
EDOKI_ACADEMY	EDOKI_ACADEMY
紧急声音	紧急声音
鬍子_照片编辑器_(Beard_Booth)	鬍子_照片编辑器_(Beard_Booth)
Europcar租车	Europcar租车
Diviniti_Publishing_Ltd	Diviniti_Publishing_Ltd
SinglesAroundMe_Inc.	SinglesAroundMe_Inc.
Chakra_Meditation	Chakra_Meditation
END.	END.
Fanpage	Fanpage
通用數碼股份有限公司	通用數碼股份有限公司
NAVER_Corp.	NAVER_Corp.
Animoca_Brands	Animoca_Brands
netroz	netroz
Damian_Bernardi	Damian_Bernardi
气喇叭	气喇叭
Shelter_Island_Mapping_Company,_LLC	Shelter_Island_Mapping_Company,_LLC
Texode_Technologies_LLC	Texode_Technologies_LLC
Azumio_Inc.	Azumio_Inc.
EF_Small_Stars	EF_Small_Stars
Chelsea_FC_-_The_5th_Stand	Chelsea_FC_-_The_5th_Stand
Giro_d'Italia	Giro_d'Italia
智能胎压	智能胎压
Nemo_Apps_LLC	Nemo_Apps_LLC
指南针	指南针
Magic_Science_House	Magic_Science_House
GT_MARKET_CONSULTING_CO.,_LTD.	GT_MARKET_CONSULTING_CO.,_LTD.
EOS_Remote	EOS_Remote
意大利足球甲级联赛	意大利足球甲级联赛
GameSpring	GameSpring
尼基:_密码日记	尼基:_密码日记
Learning_Genie_Inc	Learning_Genie_Inc
Joaquin_Grech	Joaquin_Grech
Hotels.com_好订网：酒店预订	Hotels.com_好订网：酒店预订
AfterShip_查快递	AfterShip_查快递
智芯优选	智芯优选
百货店RPG	百货店RPG
woodsmall_inc.	woodsmall_inc.
PRISONER～浮気じゃないわ	PRISONER～浮気じゃないわ
Baskaran_Arunasalam	Baskaran_Arunasalam
Mommymove_-_怀孕后妈妈的个人培训	Mommymove_-_怀孕后妈妈的个人培训
Slava_Barouline	Slava_Barouline
登山赛车2_-_Hill_Climb_Racing_2	登山赛车2_-_Hill_Climb_Racing_2
StarTaster_Technology_Pte_Ltd	StarTaster_Technology_Pte_Ltd
Tasmanic_Editions	Tasmanic_Editions
Easybrain	Easybrain
侏罗纪世界真相	侏罗纪世界真相
Magma_Mobile	Magma_Mobile
Wire_and_Wireless_Co.,Ltd.	Wire_and_Wireless_Co.,Ltd.
BlackBerry_AtHoc	BlackBerry_AtHoc
Sofia_Soft	Sofia_Soft
Jazz24:_Streaming_Jazz_24/7	Jazz24:_Streaming_Jazz_24/7
Outfit7_Limited	Outfit7_Limited
交友约会，寻找真爱	交友约会，寻找真爱
Home_Design_3D:_My_Dream_Home	Home_Design_3D:_My_Dream_Home
wonderkind_GmbH	wonderkind_GmbH
Marijn_Dillen	Marijn_Dillen
照明计算器	照明计算器
T4_Software,_Inc.	T4_Software,_Inc.
Prathed_Sangwongvanit	Prathed_Sangwongvanit
GN_Hearing	GN_Hearing
Volcano_Technology_Limited	Volcano_Technology_Limited
婴儿监视器	婴儿监视器
Bibi.Pet_-_Toddlers_Games_-_Colors_and_Shapes	Bibi.Pet_-_Toddlers_Games_-_Colors_and_Shapes
ChillyRoom	ChillyRoom
Loop_Games	Loop_Games
Cloud_Baby_Monitor	Cloud_Baby_Monitor
Deepblu:_潜水社群日志	Deepblu:_潜水社群日志
Aurora_Forecast_3D	Aurora_Forecast_3D
Studio_Pango	Studio_Pango
Defense_Zone_HD_Lite	Defense_Zone_HD_Lite
咪嘥嘢	咪嘥嘢
卡片对消之王	卡片对消之王
重卡归来	重卡归来
InPeria	InPeria
Hospital_Authority	Hospital_Authority
inkOfPixel_srl	inkOfPixel_srl
Lyrebird_Studio	Lyrebird_Studio
NFC_TagInfo_by_NXP	NFC_TagInfo_by_NXP
杂务和零用钱机器人	杂务和零用钱机器人
PreSonus_Audio_Electronics,_Inc.	PreSonus_Audio_Electronics,_Inc.
变形金刚救援机器人：英雄历险记	变形金刚救援机器人：英雄历险记
置业专家	置业专家
Smart_Sensor_Platform	Smart_Sensor_Platform
Shell_Racing	Shell_Racing
South_China_Morning_Post_Publishers_Limited	South_China_Morning_Post_Publishers_Limited
Jump_Rope_Training_App	Jump_Rope_Training_App
Loyverse	Loyverse
Citymapper_Limited	Citymapper_Limited
Cami_Calculator	Cami_Calculator
YovoGames	YovoGames
我的怀孕计算器	我的怀孕计算器
iCandy_Digital	iCandy_Digital
Lion_Studios	Lion_Studios
SPLENDID_RESEARCH_GmbH	SPLENDID_RESEARCH_GmbH
Lightricks_Ltd.	Lightricks_Ltd.
Adam_Ratana	Adam_Ratana
亚洲艺术博物馆	亚洲艺术博物馆
Touchzing_Media	Touchzing_Media
myID_Limited	myID_Limited
LuxuryEstate_-豪宅,_高端物业,_奢华别墅	LuxuryEstate_-豪宅,_高端物业,_奢华别墅
AHUA_阿華有事嗎_韓襪商城	AHUA_阿華有事嗎_韓襪商城
建行(港澳)手机客户端	建行(港澳)手机客户端
Google_LLC	Google_LLC
bonbongame.com	bonbongame.com
Open_Food_Facts	Open_Food_Facts
IMSLP	IMSLP
QQ邮箱	QQ邮箱
Reticode	Reticode
MPay澳門錢包	MPay澳門錢包
Windy_Weather_World_Inc	Windy_Weather_World_Inc
玩具坦克对战坦克	玩具坦克对战坦克
Stream_Vision	Stream_Vision
灵魂电台	灵魂电台
BCM_eCorp流動銀行	BCM_eCorp流動銀行
Pedometer	Pedometer
Media_Publishing_Limited	Media_Publishing_Limited
AnyDesk_Software_GmbH	AnyDesk_Software_GmbH
Adobe_Sign	Adobe_Sign
Athena_Studio	Athena_Studio
在线跳棋	在线跳棋
EON_46	EON_46
和Smart-Teacher一起学习中文语单词	和Smart-Teacher一起学习中文语单词
爵士乐电台	爵士乐电台
Apalon_Apps	Apalon_Apps
Mahjong	Mahjong
BoC_Bill_收錢快	BoC_Bill_收錢快
花旗掌上银行	花旗掌上银行
Salon™	Salon™
缪斯计划_-_Project:_Muse	缪斯计划_-_Project:_Muse
Citrix_SSO	Citrix_SSO
Wonderful_Games_AG	Wonderful_Games_AG
HID_Mobile_Access	HID_Mobile_Access
BLUELINDEN	BLUELINDEN
孕期瑜伽_|_Down_Dog	孕期瑜伽_|_Down_Dog
Let's_Sing_Mic	Let's_Sing_Mic
Naver_Papago_-_AI_翻译	Naver_Papago_-_AI_翻译
Premier_League_-_Official_App	Premier_League_-_Official_App
