上海寰创网络科技有限公司	上海寰创网络科技有限公司
U享代驾车主	U享代驾车主
NFit	NFit
泡泡兔益智宝箱	泡泡兔益智宝箱
江苏常熟农村商业银行股份有限公司	江苏常熟农村商业银行股份有限公司
合肥康聆医疗科技有限公司	合肥康聆医疗科技有限公司
锦浪家庭版	锦浪家庭版
江苏江南农村商业银行股份有限公司	江苏江南农村商业银行股份有限公司
上海嘉礴信息科技有限公司	上海嘉礴信息科技有限公司
上海智众医疗科技有限公司	上海智众医疗科技有限公司
JAJAHOME	JAJAHOME
绿色电力网	绿色电力网
福建博思软件股份有限公司	福建博思软件股份有限公司
BOSS智慧门店	BOSS智慧门店
经典复读机	经典复读机
Jumpin	Jumpin
大华智能锁	大华智能锁
BPROAD	BPROAD
山西迈特锐科技有限公司	山西迈特锐科技有限公司
成都积微物联电子商务有限公司	成都积微物联电子商务有限公司
北京易贝乐科技文化股份有限公司	北京易贝乐科技文化股份有限公司
广州默尼互联网信息有限公司	广州默尼互联网信息有限公司
天津微迪加科技有限公司	天津微迪加科技有限公司
DJI_GO_4	DJI_GO_4
CFMOTO	CFMOTO
Dollsky	Dollsky
广东柏高保设备工程有限公司	广东柏高保设备工程有限公司
Card_Scanner	Card_Scanner
美骑	美骑
重庆青灯网络科技有限公司	重庆青灯网络科技有限公司
深圳市极点信息科技有限公司	深圳市极点信息科技有限公司
无锡睿米信息技术有限公司	无锡睿米信息技术有限公司
高佣联盟	高佣联盟
F6智慧门店	F6智慧门店
飞常准业内版	飞常准业内版
Smartho	Smartho
广州财略金融信息科技有限公司	广州财略金融信息科技有限公司
上海看看智能科技有限公司	上海看看智能科技有限公司
APICloud助手	APICloud助手
UI之家	UI之家
广东南方智运汽车科技有限公司	广东南方智运汽车科技有限公司
Footish	Footish
深圳市花生科技有限公司	深圳市花生科技有限公司
中英文双语小说	中英文双语小说
HryFine	HryFine
山东聚米电子商务有限公司	山东聚米电子商务有限公司
成都艾途教育科技有限公司	成都艾途教育科技有限公司
付霸信息科技有限公司	付霸信息科技有限公司
FingerABC教师端	FingerABC教师端
LED灯牌显示屏滚动字幕	LED灯牌显示屏滚动字幕
上汽通用五菱汽车股份有限公司	上汽通用五菱汽车股份有限公司
AI医养云	AI医养云
武汉奥莱尔科技发展有限公司	武汉奥莱尔科技发展有限公司
健康六安	健康六安
EZCast	EZCast
MEDO体育	MEDO体育
DJI_Mimo	DJI_Mimo
山东招财万福网络科技有限公司	山东招财万福网络科技有限公司
南京桃李天下教育科技有限公司	南京桃李天下教育科技有限公司
TONY_AI	TONY_AI
杭州大白科技有限公司	杭州大白科技有限公司
中国国际广播电台	中国国际广播电台
日历	日历
超级校园	超级校园
RobinX	RobinX
深圳市卓联启航科技有限公司	深圳市卓联启航科技有限公司
广东德诚大数据科技有限公司	广东德诚大数据科技有限公司
HP_Smart	HP_Smart
进贤睿智电子科技有限公司	进贤睿智电子科技有限公司
河南中原消费金融股份有限公司	河南中原消费金融股份有限公司
语音备忘录	语音备忘录
广州市玄武无线科技股份有限公司	广州市玄武无线科技股份有限公司
E实名	E实名
孕e家	孕e家
长沙市轨道交通集团有限公司	长沙市轨道交通集团有限公司
云端学习	云端学习
吃药啦	吃药啦
ZY_Play	ZY_Play
金华市远谋科技有限公司	金华市远谋科技有限公司
广州观迪传媒有限公司	广州观迪传媒有限公司
北京欧客云科技有限公司	北京欧客云科技有限公司
Dyson_Link	Dyson_Link
润钱包	润钱包
全国12315平台	全国12315平台
魔音变声器	魔音变声器
深圳市凯迪克文化传播有限公司	深圳市凯迪克文化传播有限公司
指南针	指南针
北京世纪高通科技有限公司	北京世纪高通科技有限公司
Da_Fit	Da_Fit
SAP_Field_Service_Management	SAP_Field_Service_Management
DD特卖	DD特卖
宝宝快乐学数字	宝宝快乐学数字
天津正楷网络技术有限公司	天津正楷网络技术有限公司
温州嘿哈科技有限公司	温州嘿哈科技有限公司
YOU选商户版	YOU选商户版
汇率换算	汇率换算
FusionAccess	FusionAccess
停车百事通	停车百事通
北京央广信科科技有限公司	北京央广信科科技有限公司
企业微信	企业微信
Peoplus	Peoplus
中公开学	中公开学
高球玩伴	高球玩伴
Libratone	Libratone
Lingumi	Lingumi
香港航空	香港航空
CoolMed	CoolMed
吉事办	吉事办
深圳市聚宝汇科技有限公司	深圳市聚宝汇科技有限公司
文字转图片	文字转图片
V380	V380
Qphoto	Qphoto
澳洲PO官网	澳洲PO官网
广州富米科技有限公司	广州富米科技有限公司
Keep	Keep
神奇脑波	神奇脑波
深圳市有传科技有限公司	深圳市有传科技有限公司
Etalk英语	Etalk英语
北京京东方健康科技有限公司	北京京东方健康科技有限公司
SciOne_Plus	SciOne_Plus
QQ邮箱	QQ邮箱
C_Video	C_Video
趣约会	趣约会
音频转换器	音频转换器
安全浏览器	安全浏览器
广发银行股份有限公司	广发银行股份有限公司
上海赛林科技有限公司	上海赛林科技有限公司
Lava店铺音乐	Lava店铺音乐
广州斯肯多媒体设计有限公司	广州斯肯多媒体设计有限公司
杭州良忆创社信息科技有限公司	杭州良忆创社信息科技有限公司
InBody	InBody
广州飞傲电子科技有限公司	广州飞傲电子科技有限公司
ETCP停车	ETCP停车
打的吧	打的吧
天天看地图	天天看地图
兰州乐智教育科技有限责任公司	兰州乐智教育科技有限责任公司
SAICLink	SAICLink
苏州黑芝麻信息科技有限公司	苏州黑芝麻信息科技有限公司
北京农商银行	北京农商银行
HR-X	HR-X
大连星汉网络有限公司	大连星汉网络有限公司
安徽焦点基因健康管理有限公司	安徽焦点基因健康管理有限公司
包头市派司网络科技有限责任公司	包头市派司网络科技有限责任公司
SERES_MOTORS	SERES_MOTORS
魔镜大师	魔镜大师
Naim	Naim
E点乐活	E点乐活
Distrii_办伴	Distrii_办伴
Joypark	Joypark
成都众德同创科技有限公司	成都众德同创科技有限公司
柬单点商家版	柬单点商家版
武汉华起物联科技有限公司	武汉华起物联科技有限公司
AI电销助手	AI电销助手
大疆商城	大疆商城
E点慧	E点慧
广东马上信息科技有限公司	广东马上信息科技有限公司
SANCTUARY	SANCTUARY
甬城泊车	甬城泊车
上海虎诚信息科技有限公司	上海虎诚信息科技有限公司
U享车生活	U享车生活
优睡	优睡
深圳市海凌科电子有限公司	深圳市海凌科电子有限公司
闪优物联	闪优物联
Ai爱管生活通	Ai爱管生活通
Chill	Chill
PDF转换	PDF转换
Stadium_Goods	Stadium_Goods
杭州联科美讯生物医药技术有限公司	杭州联科美讯生物医药技术有限公司
OK支付	OK支付
山东省党员干部现代远程教育中心	山东省党员干部现代远程教育中心
星轨体育	星轨体育
MyDigi	MyDigi
EufyLife	EufyLife
梅赛德斯-奔驰应用程序	梅赛德斯-奔驰应用程序
扫码	扫码
Filemail:_Send_large_files	Filemail:_Send_large_files
钢琴键盘	钢琴键盘
BIM管控系统	BIM管控系统
中国信鸽信息网	中国信鸽信息网
卡通头像制作	卡通头像制作
英语翻译	英语翻译
上海有树文化传播有限公司	上海有树文化传播有限公司
听宝宝说	听宝宝说
易适康连(上海)科技有限公司	易适康连(上海)科技有限公司
东方红	东方红
上海开果传媒科技有限公司	上海开果传媒科技有限公司
安付宝商务有限公司	安付宝商务有限公司
V观剧场	V观剧场
北京美华博通科技有限公司	北京美华博通科技有限公司
桌面时钟	桌面时钟
微众企业爱普	微众企业爱普
FlagFit	FlagFit
豆瓣	豆瓣
Let’s_Go	Let’s_Go
完美钢琴	完美钢琴
儿童手表	儿童手表
体重记录	体重记录
永不言弃	永不言弃
我的链接	我的链接
MP3提取转换器	MP3提取转换器
音呗	音呗
深圳星普森信息技术有限公司	深圳星普森信息技术有限公司
医快付	医快付
B+_快销	B+_快销
云知行	云知行
交银人寿	交银人寿
DaDa英语	DaDa英语
PixPlus	PixPlus
CMR智慧监考	CMR智慧监考
北京光线易视网络科技有限公司	北京光线易视网络科技有限公司
Fitback助教	Fitback助教
沈阳市营商环境建设监督局	沈阳市营商环境建设监督局
上海宸慧医学科技有限公司	上海宸慧医学科技有限公司
WindLink	WindLink
经脉宝	经脉宝
Zoho_Projects	Zoho_Projects
咕咕信鸽	咕咕信鸽
扫描仪pdf	扫描仪pdf
中国银行股份有限公司	中国银行股份有限公司
重庆典谟科技有限公司	重庆典谟科技有限公司
Bose音乐	Bose音乐
北京地厚云图科技有限公司	北京地厚云图科技有限公司
Fwatch	Fwatch
E英语宝	E英语宝
北京久其云福科技有限公司	北京久其云福科技有限公司
NCF	NCF
Xplova_Connect	Xplova_Connect
墨斗科技	墨斗科技
SCC健康助手	SCC健康助手
ERSTEK	ERSTEK
MobIR_Pin	MobIR_Pin
FITUP	FITUP
江苏中海昇物联科技有限公司	江苏中海昇物联科技有限公司
DYP伙伴	DYP伙伴
国务院	国务院
上海瑜易网络科技有限公司	上海瑜易网络科技有限公司
厦门众库科技有限公司	厦门众库科技有限公司
e龙岩	e龙岩
卡洛动	卡洛动
山东鲁能泰山足球俱乐部股份有限公司	山东鲁能泰山足球俱乐部股份有限公司
北京银行	北京银行
TrainingPeaks	TrainingPeaks
JEET_Play	JEET_Play
北京敏特昭阳科技发展有限公司	北京敏特昭阳科技发展有限公司
DAO_VALLEY	DAO_VALLEY
南通普润特数码科技有限公司	南通普润特数码科技有限公司
E充站	E充站
北京有路前行科技发展有限公司	北京有路前行科技发展有限公司
DynEd	DynEd
重庆天极云服科技有限公司	重庆天极云服科技有限公司
江西五十铃汽车有限公司	江西五十铃汽车有限公司
Bluclock	Bluclock
摩贝密盾	摩贝密盾
珠海豆饭科技有限公司	珠海豆饭科技有限公司
腾讯医典	腾讯医典
宁波大赢家物流技术有限公司	宁波大赢家物流技术有限公司
LIANKS	LIANKS
Xunku_Gears	Xunku_Gears
Pack6	Pack6
海康慧眼	海康慧眼
上海友健网络科技有限公司	上海友健网络科技有限公司
邦吉粮油	邦吉粮油
IUU旅行	IUU旅行
北京粉笔蓝天科技有限公司	北京粉笔蓝天科技有限公司
西南证券股份有限公司	西南证券股份有限公司
厦门市易联众易惠科技有限公司	厦门市易联众易惠科技有限公司
Maplesoft	Maplesoft
福建天创信息科技有限公司	福建天创信息科技有限公司
Tenda_WiFi	Tenda_WiFi
北京青牛出关科技有限公司	北京青牛出关科技有限公司
路影	路影
AA司机端	AA司机端
广州英荔教育科技有限公司	广州英荔教育科技有限公司
ACCA_Helper	ACCA_Helper
上海迅时通信设备有限公司	上海迅时通信设备有限公司
武汉金里程信息科技有限公司	武汉金里程信息科技有限公司
GTWatch	GTWatch
Mira觅蕊	Mira觅蕊
成都心吉康科技有限公司	成都心吉康科技有限公司
河北源达信息技术股份有限公司	河北源达信息技术股份有限公司
杭州优行科技有限公司	杭州优行科技有限公司
上海创赋医疗科技有限公司	上海创赋医疗科技有限公司
深圳市海豚村信息技术有限公司	深圳市海豚村信息技术有限公司
G7_CRM	G7_CRM
深圳和而泰家居在线网络科技有限公司	深圳和而泰家居在线网络科技有限公司
HAVAL智拍	HAVAL智拍
Stream_Vision	Stream_Vision
EK爱车	EK爱车
LeveTop	LeveTop
WEIZHIIOT	WEIZHIIOT
深圳市前海硕极科技有限公司	深圳市前海硕极科技有限公司
北京正在关怀科技有限公司	北京正在关怀科技有限公司
GMT全球购	GMT全球购
深圳市盈生科技有限公司上海分公司	深圳市盈生科技有限公司上海分公司
OS零售	OS零售
SleepNote	SleepNote
七普智能	七普智能
吴川脚爆爆	吴川脚爆爆
变脸大咖	变脸大咖
杭州稀世璎珞网络科技有限公司	杭州稀世璎珞网络科技有限公司
VV健康宝	VV健康宝
四川奥尔博睿信息技术有限公司	四川奥尔博睿信息技术有限公司
随即拍	随即拍
AI智行	AI智行
上海震渊信息技术有限公司	上海震渊信息技术有限公司
深圳市壹路通科技有限公司	深圳市壹路通科技有限公司
公主爱情婚礼故事	公主爱情婚礼故事
杭州笔声智能科技有限公司	杭州笔声智能科技有限公司
DuoWear	DuoWear
杭州新闻	杭州新闻
我家守护	我家守护
江西一点信息技术有限公司	江西一点信息技术有限公司
浙江过家家信息科技有限公司	浙江过家家信息科技有限公司
精读圣经	精读圣经
深圳市贸人科技有限公司	深圳市贸人科技有限公司
远程电脑	远程电脑
KIWI运动	KIWI运动
上海卫宁数据科技有限公司	上海卫宁数据科技有限公司
美大	美大
苏州西顿家用自动化有限公司	苏州西顿家用自动化有限公司
MOO音乐	MOO音乐
智能云	智能云
北京金兆路华电子商务有限公司	北京金兆路华电子商务有限公司
友空间	友空间
DJ秀	DJ秀
Bluwedr	Bluwedr
广州TCL互联网小额贷款有限公司	广州TCL互联网小额贷款有限公司
上海办伴科技发展有限公司	上海办伴科技发展有限公司
魅动	魅动
慧生活798	慧生活798
海南麦奇科技有限公司	海南麦奇科技有限公司
QQ	QQ
政采云	政采云
武汉光谷联合集团有限公司	武汉光谷联合集团有限公司
Microsoft_Excel	Microsoft_Excel
联华鲸选	联华鲸选
Play_it_Say_it	Play_it_Say_it
星图	星图
北京明德新民体育文化有限公司	北京明德新民体育文化有限公司
WPS_Office	WPS_Office
北京瀚维特科技有限公司	北京瀚维特科技有限公司
SaxoTraderGO	SaxoTraderGO
ECLEAR	ECLEAR
Fengon_Link	Fengon_Link
GiWiFi校园助手	GiWiFi校园助手
北京蒸汽澄海科技有限公司	北京蒸汽澄海科技有限公司
北京汉雅天诚教育科技有限公司	北京汉雅天诚教育科技有限公司
Acura_DVR	Acura_DVR
广州微房团网络科技有限公司	广州微房团网络科技有限公司
乐清公交	乐清公交
湖南优积谷网络科技有限公司	湖南优积谷网络科技有限公司
杭州乐刻网络技术有限公司	杭州乐刻网络技术有限公司
小蚁运动相机	小蚁运动相机
四川人社	四川人社
招财拍	招财拍
Ultra_Stream	Ultra_Stream
FE文件管理器	FE文件管理器
Youth_health	Youth_health
SeTracker2	SeTracker2
IMOM	IMOM
CMDB	CMDB
爱心人寿保险股份有限公司	爱心人寿保险股份有限公司
天天手环	天天手环
浙江和仁科技股份有限公司	浙江和仁科技股份有限公司
Microsoft_Word	Microsoft_Word
深圳市看见文化传播有限公司	深圳市看见文化传播有限公司
浙江春风动力股份有限公司	浙江春风动力股份有限公司
北京高途云集教育科技有限公司	北京高途云集教育科技有限公司
北京幕威艾迪网络科技有限公司	北京幕威艾迪网络科技有限公司
YN智慧校园	YN智慧校园
北京自然力量科技贸易发展有限公司	北京自然力量科技贸易发展有限公司
V_day	V_day
浙江文澜信息发展有限公司	浙江文澜信息发展有限公司
ACCA泽稷智题库	ACCA泽稷智题库
少女与猫	少女与猫
儿童体温贴	儿童体温贴
广州比地数据科技有限公司	广州比地数据科技有限公司
NEXGIM	NEXGIM
E照通	E照通
北京创新乐知信息技术有限公司	北京创新乐知信息技术有限公司
上饶市星嘉文化传播有限公司	上饶市星嘉文化传播有限公司
Hi_医生	Hi_医生
成都神州龙行环保科技有限公司	成都神州龙行环保科技有限公司
Info_BMKG	Info_BMKG
杭州链录网络科技有限公司	杭州链录网络科技有限公司
北京玩途自由行技术有限公司	北京玩途自由行技术有限公司
Ele学堂	Ele学堂
曹操加盟司机	曹操加盟司机
FocusZen	FocusZen
安徽华格科技有限公司	安徽华格科技有限公司
Utalk视听实训	Utalk视听实训
PowerBand	PowerBand
E视网	E视网
AdorHealth	AdorHealth
V展	V展
DrMic	DrMic
广西等他信息科技有限公司	广西等他信息科技有限公司
广州途道信息科技有限公司	广州途道信息科技有限公司
中山天气	中山天气
中国政府网运行中心	中国政府网运行中心
深圳酷宅科技有限公司	深圳酷宅科技有限公司
深圳潜水侠创新动力科技有限公司	深圳潜水侠创新动力科技有限公司
DAVID_KKM	DAVID_KKM
北京海腾时代科技有限公司	北京海腾时代科技有限公司
Ai竞拍	Ai竞拍
Italk	Italk
HARDfit	HARDfit
GrapeSEED	GrapeSEED
韵达优配	韵达优配
天津飞猫智联科技有限公司	天津飞猫智联科技有限公司
Zion健康	Zion健康
河北云客科技有限公司	河北云客科技有限公司
天津迈即刻网络科技有限公司	天津迈即刻网络科技有限公司
List背单词	List背单词
X方	X方
AYOU视频	AYOU视频
FO学院	FO学院
RDFit	RDFit
深圳市三分之一睡眠科技有限公司	深圳市三分之一睡眠科技有限公司
G直播	G直播
粉瓣书城	粉瓣书城
北京无边际信息科技有限公司	北京无边际信息科技有限公司
东莞市迪尚智能生活科技有限公司	东莞市迪尚智能生活科技有限公司
广州高分说信息科技有限公司	广州高分说信息科技有限公司
深圳尚一互联技术有限公司	深圳尚一互联技术有限公司
上海文方教育科技有限公司	上海文方教育科技有限公司
My_BMW	My_BMW
广西澳小黄科技有限公司	广西澳小黄科技有限公司
北京润脉科技有限公司	北京润脉科技有限公司
Lufthansa	Lufthansa
湖南亲信信息科技有限公司	湖南亲信信息科技有限公司
HUAWEI_HiLink	HUAWEI_HiLink
文字转语音	文字转语音
中国移动通信集团山西有限公司	中国移动通信集团山西有限公司
厦门正辰通信科技有限公司	厦门正辰通信科技有限公司
北京锦益网络科技有限公司	北京锦益网络科技有限公司
UniFi_Network	UniFi_Network
天天向上	天天向上
TOP论坛	TOP论坛
桂林飞宇科技股份有限公司	桂林飞宇科技股份有限公司
B365健康管理	B365健康管理
广州敬信药草园信息科技有限公司	广州敬信药草园信息科技有限公司
威海市民卡有限公司	威海市民卡有限公司
F_Fit	F_Fit
上海享互网络科技有限公司	上海享互网络科技有限公司
MinttiVision	MinttiVision
屏掌控	屏掌控
TheONE爱练琴	TheONE爱练琴
GPS工具箱	GPS工具箱
马良	马良
Coremail论客	Coremail论客
伊对	伊对
沈阳政务服务	沈阳政务服务
Neon_Photo_Editor	Neon_Photo_Editor
湖北星轨体育科技有限公司	湖北星轨体育科技有限公司
四川省人力资源和社会保障信息中心	四川省人力资源和社会保障信息中心
CarAuto	CarAuto
上海洛育教育科技有限公司	上海洛育教育科技有限公司
DrKing	DrKing
UpToDate	UpToDate
Polestar极星	Polestar极星
S365	S365
TP-LINK安防	TP-LINK安防
H3C魔术家	H3C魔术家
Emirates	Emirates
厦门市四美达科技发展有限公司	厦门市四美达科技发展有限公司
PMS	PMS
e物联	e物联
深圳市点嘀互联网络有限公司	深圳市点嘀互联网络有限公司
惠民医疗	惠民医疗
ES文件浏览器	ES文件浏览器
ECNUP外语	ECNUP外语
FAMAR	FAMAR
深圳市我家守护科技有限公司	深圳市我家守护科技有限公司
上海紫薯软件技术有限公司	上海紫薯软件技术有限公司
U易付管家	U易付管家
UControl	UControl
CGC推广助手	CGC推广助手
深圳市云中飞电子有限公司	深圳市云中飞电子有限公司
翻译	翻译
WALNUTT_GO	WALNUTT_GO
米家	米家
广州品好尚信息科技有限公司	广州品好尚信息科技有限公司
成都索贝数码科技股份有限公司	成都索贝数码科技股份有限公司
a卡	a卡
上海万利保险经纪有限公司	上海万利保险经纪有限公司
CBN幸福娱乐	CBN幸福娱乐
深圳向量之美科技有限公司	深圳向量之美科技有限公司
长沙市火鸟软件科技有限公司	长沙市火鸟软件科技有限公司
宁波市政公用投资有限公司	宁波市政公用投资有限公司
VIPKID启蒙	VIPKID启蒙
山西移动	山西移动
ASIAIR	ASIAIR
滑板圈	滑板圈
Philips	Philips
Bamboo_Paper	Bamboo_Paper
艺心动	艺心动
WiFi魔盒	WiFi魔盒
威海报讯融媒体有限公司	威海报讯融媒体有限公司
RCC车管家	RCC车管家
广州龙之杰科技有限公司	广州龙之杰科技有限公司
Patient_Cloud	Patient_Cloud
深圳市艺漫新科技发展有限公司	深圳市艺漫新科技发展有限公司
Artand	Artand
华医通	华医通
上海世糯五幺健身服务有限公司	上海世糯五幺健身服务有限公司
地震讯息	地震讯息
北京红中国际教育文化有限公司	北京红中国际教育文化有限公司
深圳市乐刷商圈科技有限公司	深圳市乐刷商圈科技有限公司
厦门中易智联网络科技股份有限公司	厦门中易智联网络科技股份有限公司
上海钧正网络科技有限公司	上海钧正网络科技有限公司
简明日语	简明日语
ESA阅卷	ESA阅卷
计算器	计算器
Simba+_Pro	Simba+_Pro
CandyBook	CandyBook
深圳市弘金地网球发展有限公司	深圳市弘金地网球发展有限公司
小贝保险经纪有限公司	小贝保险经纪有限公司
杭州位育网络科技有限公司	杭州位育网络科技有限公司
HiAi	HiAi
乐刻教练	乐刻教练
天津磐达科技有限公司	天津磐达科技有限公司
NC_InClass	NC_InClass
O计	O计
ABC_Phonics	ABC_Phonics
中创物流股份有限公司	中创物流股份有限公司
贵州我联你联网络技术有限公司	贵州我联你联网络技术有限公司
拔草哦	拔草哦
源动健康	源动健康
SmartFit_Mini	SmartFit_Mini
Mibro_Fit	Mibro_Fit
上海会畅通讯股份有限公司	上海会畅通讯股份有限公司
中国移动通信集团江西有限公司	中国移动通信集团江西有限公司
MMC管家	MMC管家
私募通	私募通
Yeelight_Pro	Yeelight_Pro
上海树莓教育科技有限公司	上海树莓教育科技有限公司
成都智学易数字科技有限公司	成都智学易数字科技有限公司
厦门智游网安科技有限公司	厦门智游网安科技有限公司
科裕蓝牙锁	科裕蓝牙锁
SOLOX	SOLOX
广州市小弹壳网络科技有限公司	广州市小弹壳网络科技有限公司
桂林智神信息技术有限公司	桂林智神信息技术有限公司
金融网点通	金融网点通
GogoTalk少儿英语	GogoTalk少儿英语
秒表计时器	秒表计时器
东莞市铺先生网络科技有限公司	东莞市铺先生网络科技有限公司
白猫贷	白猫贷
政采云有限公司	政采云有限公司
小米运动	小米运动
浙江无我科技有限公司	浙江无我科技有限公司
上海易路软件有限公司	上海易路软件有限公司
杭州六倍体科技有限公司	杭州六倍体科技有限公司
辽宁尔雅网信科技有限公司	辽宁尔雅网信科技有限公司
瞩目国际版	瞩目国际版
TP-LINK	TP-LINK
北京坦恩创意科技有限公司	北京坦恩创意科技有限公司
广州趣丸网络科技有限公司	广州趣丸网络科技有限公司
上海銮幕信息科技有限公司	上海銮幕信息科技有限公司
GHome	GHome
南京设易网络科技有限公司	南京设易网络科技有限公司
欧姆龙笔记	欧姆龙笔记
北京通安信息技术有限公司	北京通安信息技术有限公司
GloryFit	GloryFit
Qfile	Qfile
语音导航	语音导航
福州朴朴电子商务有限公司	福州朴朴电子商务有限公司
北京简影优视科技有限公司	北京简影优视科技有限公司
浙江工汇网络科技有限公司	浙江工汇网络科技有限公司
移动云坐席	移动云坐席
天天智跑	天天智跑
北京虚实科技有限公司	北京虚实科技有限公司
Fancy_App	Fancy_App
广州讯飞易听说网络科技有限公司	广州讯飞易听说网络科技有限公司
房车之家	房车之家
PEPEC900句	PEPEC900句
北京米连科技有限公司	北京米连科技有限公司
Hohem_Pro	Hohem_Pro
VPhoto摄影师	VPhoto摄影师
斑马赛事通	斑马赛事通
E店通	E店通
U饭云餐-高校版	U饭云餐-高校版
温湿度计	温湿度计
城客e家司机端	城客e家司机端
IPC360	IPC360
北京慕华信息科技有限公司	北京慕华信息科技有限公司
利亚德光电股份有限公司	利亚德光电股份有限公司
深圳华大基因科技服务有限公司	深圳华大基因科技服务有限公司
万豪旅享家	万豪旅享家
海峡银行	海峡银行
MooFit	MooFit
杭州市公共交通云科技股份有限公司	杭州市公共交通云科技股份有限公司
尚阳科技股份有限公司	尚阳科技股份有限公司
Modix	Modix
智能胎压	智能胎压
LoungeKey	LoungeKey
田东世新文化传媒有限责任公司	田东世新文化传媒有限责任公司
U聘	U聘
Anjou_香薰机	Anjou_香薰机
掌上大学	掌上大学
Fitkid	Fitkid
听佛经	听佛经
鲜娱科技有限公司	鲜娱科技有限公司
深圳市企鹅网络科技有限公司	深圳市企鹅网络科技有限公司
威海市民卡	威海市民卡
运动秀	运动秀
QQ空间	QQ空间
生酮营养师	生酮营养师
聚米团	聚米团
贵州慈恩软件开发有限公司	贵州慈恩软件开发有限公司
InLED	InLED
上海卓赞教育科技有限公司	上海卓赞教育科技有限公司
上海有你信息科技有限公司	上海有你信息科技有限公司
淮安市江淮信息科技有限公司	淮安市江淮信息科技有限公司
江苏恩创信息技术有限公司	江苏恩创信息技术有限公司
ECH健康	ECH健康
长沙年余信息科技有限公司	长沙年余信息科技有限公司
武汉中科图灵科技有限公司	武汉中科图灵科技有限公司
Flow_Fit	Flow_Fit
CBLV8	CBLV8
深圳市车百路科技有限公司	深圳市车百路科技有限公司
柳州气象	柳州气象
优享校园	优享校园
杭州天作之合信息技术有限公司	杭州天作之合信息技术有限公司
深圳前海中领国际管理咨询有限公司	深圳前海中领国际管理咨询有限公司
华为亿家	华为亿家
HeMi学社	HeMi学社
广州中博教育股份有限公司	广州中博教育股份有限公司
SumanSoul教练	SumanSoul教练
InMedTube	InMedTube
江苏叁点壹肆信息科技有限公司	江苏叁点壹肆信息科技有限公司
简笔画	简笔画
中国建设银行	中国建设银行
北京紫石音讯通信技术有限公司	北京紫石音讯通信技术有限公司
环球生意通	环球生意通
ATLAS_寰图	ATLAS_寰图
蛙色VR	蛙色VR
天津公安	天津公安
空港易行	空港易行
TCL普惠	TCL普惠
A索早教	A索早教
长沙云多啦信息技术有限公司	长沙云多啦信息技术有限公司
成都爱乐学教育科技有限公司	成都爱乐学教育科技有限公司
成都市洛塔网络科技有限公司	成都市洛塔网络科技有限公司
小艺帮	小艺帮
EasyConnect	EasyConnect
江苏金恒信息科技有限公司	江苏金恒信息科技有限公司
深圳市桃源纪科技有限公司	深圳市桃源纪科技有限公司
央视文艺	央视文艺
上海城方租赁住房运营管理有限公司	上海城方租赁住房运营管理有限公司
安徽好马科技有限公司	安徽好马科技有限公司
昭昭医考	昭昭医考
珠海横琴跨境说网络科技有限公司	珠海横琴跨境说网络科技有限公司
欧姆龙低频	欧姆龙低频
深圳市必提学院教育科技有限公司	深圳市必提学院教育科技有限公司
RCC工程招采	RCC工程招采
AA出行司机	AA出行司机
MallHaHa	MallHaHa
北京中公教育科技股份有限公司	北京中公教育科技股份有限公司
深圳云企合一信息科技有限公司	深圳云企合一信息科技有限公司
安徽安大笃北信息科技有限责任公司	安徽安大笃北信息科技有限责任公司
KISSABC	KISSABC
广东弘智科技有限公司	广东弘智科技有限公司
Thai_Airways	Thai_Airways
天津海厚科技发展有限公司	天津海厚科技发展有限公司
PKPM智慧工厂	PKPM智慧工厂
上海时代光华教育发展有限公司	上海时代光华教育发展有限公司
河南省863软件孵化器有限公司	河南省863软件孵化器有限公司
广州三毛信息科技有限公司	广州三毛信息科技有限公司
浙江众匠信息技术有限公司	浙江众匠信息技术有限公司
名家景选	名家景选
WPS精品课	WPS精品课
高分说新版	高分说新版
GoFun车服众包	GoFun车服众包
天翼视讯传媒有限公司	天翼视讯传媒有限公司
江苏信臣健康科技股份有限公司	江苏信臣健康科技股份有限公司
青岛轮子软件科技有限公司	青岛轮子软件科技有限公司
魔洁兔	魔洁兔
LigoHud	LigoHud
WiFi_UAV	WiFi_UAV
U点管家	U点管家
RCFans遥控迷	RCFans遥控迷
广州艾拉网络技术有限公司	广州艾拉网络技术有限公司
深圳市京华信息技术有限公司	深圳市京华信息技术有限公司
Rainbow	Rainbow
思锐	思锐
热动	热动
深圳前海好的互联网科技有限公司	深圳前海好的互联网科技有限公司
高中物理大全	高中物理大全
深圳酷享信息科技有限公司	深圳酷享信息科技有限公司
畅行九州	畅行九州
Hi运动	Hi运动
