照顾甜心妹妹	照顾甜心妹妹
儿童学动物游戏	动物游戏的孩子
广州地铁	广州地铁通
微博国际版	微博国际版
个人简历	个人简历
缅甸语翻译	缅甸语泰语翻译
DISC_LINK_Platinum	DISC_LINK_Platinum
PDF_Reader阅读器	PDF_Reader
美食星球	Food_Planner
相片拼贴	Photo_Collage
相片拼贴	照片拼貼_-_Photo_Collage
Nur输入法	GO输入法
天气神通	天气哇
梦幻家园设计	梦想家园--设计师
英语听力宝	English_Listening_Test
儿童宝宝超市	儿童超市
立即定位	立即定位
赚钱帮	赚钱博客
热爱	爱情
女生学做饭	女孩学画画
中医方剂	中医方剂
精读圣经	精读圣经
宝宝假日旅行	宝宝假日旅行
海贝音乐	海贝音乐
视频格式工厂	Video_Format_Factory
AR相机	VR摄像机
23魔方	魔方
时间记录	时光记录
Ai学英语	学英语
延安公交	Tehran_Public_Transport
我的排班表	我的日程表
V380_Pro	V380_Pro
恐龙	恐龙
猜猜这是谁	猜猜看
东方赛事	复活节游戏
嘀嗒计步器	步行的计步器
KK直播	VK_Live
一键截屏	一键截屏
叮叮日记	青青日记
法语学习	学习法语
脱壳	拼写检查
有我看家	有我看家
拼图	拼图
美好生活家园	Beautiful_Life_Quotes
Patient_Cloud	Patient_Cloud
高清影音播放器	高清视频播放器
DS_cam	DS_cam
英语翻译词典	法语翻译词典
Gallery	画廊
公主舞会化妆装扮沙龙	Princess_Beauty_Makeup_Salon
笔记本	筆記，記事本，筆記本
约订商家版	Booksy（商家版
电视遥控器	对于电视遥控器
变声器变声吧	变声器
一刻日记	时光日记
China_Airlines_App	China_Airlines_App
婚礼请柬	结婚请柬
如丽整形	Body_Plastic_Surgery
小键盘	粉红色_键盘
语音转文字	语音转文字
ZAFUL_-_My_Fashion_Story	ZAFUL_-_My_Fashion_Story
中医堂	中医中药
二胡调音器	二胡调音器
宝宝地震安全3	宝宝地震安全2
译学馆	译学馆
百布	百度
织里365	智家365
Q日记	Q日记
极度扫描	极限着陆
蜜蜂	蜜蜂
喝水助手	喝水助手
高德地图	高德地图
EX文件管理器	File_Manager
儿童小汽车	孩子们的蠕虫
映画	Mapping
有喜	优信
全能电视遥控器	通用电视遥控器
小小证件照	智能证件照
Gear_S插件	Gear_S_Plugin
中医药	中医中药
个人简历制作	简历创建者
乐扬英语听说	English_Listening_and_Speaking
iLight	Wyth
婚礼蛋糕设计	婚礼蛋糕设计
私密浏览器	Private_Browser
图片搜搜	Image_Search
图片搜搜	图片搜索
简明日语	简明日语
动漫卡通头像制作	动漫_装扮_头像制作
钢琴演奏大师	钢琴大师2
新浪金融	新浪财经
云闪付	云闪付
搜箱	求职
懒虫闹钟	大声闹钟
保险侠	保险法
游戏录屏大师	游戏录屏大师
小尼运动	小米运动
深圳地铁	深圳地铁通
熊猫中医	中医中药
扬帆	钉钉
HD_Wallpapers	高清壁纸
HD_Wallpapers	HD_Wallpapers
好学点	轻松学
现代汉语大词典	Oxford_Chinese_Dictionary
光阴日记	时光日记
随机数生成器	随机数发生器
摩的小车司机	机车骑士
装扮小公主	装扮小公主
小小厨房	小廚房
动物的声音	动物的声音
手机搬家	手机搬家
洗车么	洗车。
最美电影	最美自拍
米家	米家
瑞卡租车	一嗨租车
洛杉矶导游	洛杉矶县指南
英语电台FM收音机	英语电台FM收音机
搜猪侠	大猎人_(Big_Hunter)
办公宝	骰宝
交银国际服务宝	交银国际服务宝
口语e考通	English_Proficiency_Test
图片扫描仪	图像扫描仪
Keep_Health	Bee_Health
H_Band	H_Band
倒放挑战	倒放挑战
语文词典	中文字典_+
速通充电	快速充电
FlashCard	Flashcards
爱乐抓娃娃机	抓娃娃机_免费
遗爱网	Home_Network
德达康健	MedM_Health
白噪音	白噪声
白噪音	White_Noise
电工手册	Справочник_электрика
史莱姆独角兽彩泥制作	史莱姆独角兽彩泥制作游戏
拼多多	拼多多
喂啦	Tello
感统训练	记忆训练
快充电	快速充电
轻描	体重跟踪
eyemore助手	记忆助手
睡眠声音	睡眠声音
Switch手柄Pro	Switch手柄Pro
完美制作蛋糕	完善_蛋糕_制作者
中医在线	中医中药
中医在线	中医自测
AppLock	应用锁_(AppLock)
AppLock	AppLock
宝宝美食派对	宝宝美食派对
Slove	爱情
KingDraw_化学结构式编辑器	KingDraw_Chemical_Structure_Editor
屏幕录像	屏幕录像机
ETC出行	旅かえる
Cv_Creator	QR創建者
照片速写	照片素描
照片速写	照片拼接
应用锁	应用锁
君和中医	中医中药
宝宝台风天气	宝宝台风天气
Bose_Sleep	Bose®_Sleep
智能证件照	智能证件照
计算器	计算器
多功能计算器	多功能计算器
一周天气预报	每小时天气预报
搞怪相机	搞怪相机
计步器	Pedometer
计步器	计步器——步数测量器
计步器	计步器
对接会助手	喝水助手
被窝设计	房屋建筑设计
被窝设计	婚礼设计师
宝宝梦想职业	宝宝梦想职业
大众点评	大众点评
Todo清单	Todo_list
独角兽橡皮糖	独角兽跑
万年历老黄历	万年历
智能体温计	智能温度计
汉语字典	中文字典_+
汉语字典	中文字典
企鹅FM	企鹅FM
学画发光公主	学画发光公主
房蚁	House_Paint
奇妙的怪物朋友	奇妙的怪物朋友
AIDA64	AIDA64
护眼大师	护眼滤镜
语音翻译	语音翻译
文件管理器	文件管理器
文件管理器	File_Manager
学习英语	学习英语
魔咔相机	Moto_相机
异乡	异乡
智能生活	智能生活
君仁中医	中医中药
单位换算	单位换算
像素涂色3D	像素填色_3D
极阅读	极限着陆
自动点击器	自动点击器
名片派	的名片
香港航空	香港航空
车立洗	洗车
最美自拍	最美自拍
牛津现代英汉大词典	牛津英汉辞书
UTo出行	旅かえる
儿童赛车	儿童赛车
宝宝巴士习惯班	宝宝巴士习惯班
一键投屏	一键投屏
biu购物	义乌购
汉语词典	中文字典_+
换算单位	单位换算
百信银行	大新銀行
健康训练营	和平训练营
驾校宝典	Driving_School_Classics
赚钱呗	赚钱
猎聘	猎聘
吉他调音	Guitar_Tuner
HP_打印服务插件	HP_Print_Service_插件
英文日文翻译	英语_中国翻译
快牙网传	快牙网传版
开心幼儿园	宝宝幼儿园
泰语翻译软件	翻译软件
美颜照相机	美妆相机
冥想音乐	冥想音乐
冥想音乐	冥想的音乐
指纹应用锁	指纹应用锁
n7player_Music_Player	n7player_Music_Player
完美做蛋糕	完善_蛋糕_制作者
朗读大师	清理大师
施工眼	建造战争
智能管家	智能管家
时光网	Home_Network
全民阅读	国家电台
企业微信	企业微信
AI浏览器	4G浏览器
腾讯视频	Tencent_Video
搜狐资讯	The_Information
头像制作器	Avatar_Maker
IN输入法	GO输入法
白噪声	白噪声
白噪声	White_Noise
科学计算器	科学计算器
现代汉语字典	Oxford_Chinese_Dictionary
现代汉语字典	韩语中文字典
现代汉语字典	Pleco_Chinese_Dictionary
鱼塘	鱼池
星座运势	星座运势
大连公交	Tehran_Public_Transport
有信	优信
Simple_Habit	简单8位
万途达车服	熊猫的汽车服务
BBAE必贝证券	BBAE必贝证券
51去水印	去水印
心情日记本	月亮日記
小决定	小决定
医疗档案	医疗记录
分贝仪	分贝计
车故事	聊天故事
拨号宝	Dialpad
Dual_Space_-_32Bit_Support	双开空间_-_64位支持
Dual_Space_-_32Bit_Support	DualSpace_Lite_-_32Bit_Support
手机克隆	手机克隆
代驾宝	支付宝
宝宝飞行员	宝宝飞行员
公关日历	MC_Calendar
天眼查车	重型车辆检验
微软翻译	微软翻译
高清相机	高清相机
高清相机	高清摄像机
伊维智能	LE_智能
恐龙数学	恐龙数学
居家安全-宝宝巴士	宝宝居家安全_-_宝宝巴士
快译英语翻译	法语英语翻译
Internet_speed_test_wifi_speed_test	互联网速度测试-Wifi速度测试
TouchRetouch	TouchRetouch
中医执业医师	中医方剂
尺子	尺子
尺子	Ruler
学习英语,法语,西班牙语,德语,意大利语,俄语,日语_-_Mondly	学习英语,法语,西班牙语,德语,意大利语,俄语,日语_-_Mondly
Ocamera	相机
90s蒸汽波特效相机App	90s_-_蒸汽波特效相机
Stream_Vision	Stream_Vision
御驾助手	Xperia助手
智能温度计	智能温度计
共享中医	中医中药
微信读书	微信读书
警察叔叔	警察叔叔
开眼	开眼
微博	微博
迅捷视频转换器	MP4视频转换器
维基百科	Wikipedia
学习意大利语	学习意大利语
Coveer	Obenkyo
SeTracker2	SeTracker
儿童学英语	小孩学英语
智慧城市	SmartCity
高清摄像机	高清相机
高清摄像机	高清摄像机
美价	Голос_Америки
Footej_Camera_2	Footej_Camera_2
艾安装	APK安装
上教英语	学英语
百家号	一加帐号
Axent智控	AI智能控制
烘焙食谱	Baking_Recipes
烘焙食谱	Baking_recipes
支付宝	支付宝
身边菜市场	伤心行情
值得播	体育广播
Maersk_Shipment	Maersk_Shipment
极简待办	极简待办
心率监测仪	心率监测器
宝宝医院-宝宝巴士	宝宝医院_-_宝宝巴士
我的外卖	98外卖
百度	百度
7_Minute	《7分钟》
简约记事本	简易记事本
小记	Notes
省钱了	赚钱
奇妙美味日记	奇妙美味日记
招商永隆一点通	招商永隆一点通
电视遥控器万能	通用电视遥控器
一键锁屏	锁屏
法律英语词典	French_English_Dictionary
DS_file	DS_file
古代汉语词典	瀚品汉英词典_(Hanping_Chinese)
Tell	Tello
变声器	变声器
厚墨	厚墨
一嗨租车	一嗨租车
欢乐小丑	欢乐扑克
C语言编译器	C语言编译器
FM电台收音机	FM_收音机
篮球教学	篮球：培训
虚拟恋人	虚拟情人
薄荷记账	薄荷记账
电视机遥控器	对于电视遥控器
PDF图片转换器	PDF_to_Image_Converter
万年历中华日历	DigiCal_日历_中文行事历
Ekran_film	Screenshot_X
Ekran_film	Screenshot
宝宝牙齿美容	宝宝牙齿美容
恐龙垃圾车	Atlas_Mission:_#1_Kids_Learning_Game_for_Ages_3-7
启明电台	古蘭經電台
启明电台	中国广播电台
华为生活服务	华为移动服务
360加密	360加密
狗狗浏览器	Tor_Browser
紫外线天气预报	天气预报
紫外线天气预报	USA_Weather_forecast
随身乐队	随身乐队
7分钟锻炼	7分钟锻炼免费
知心心率	心率
Louis_Vuitton	Louis_Vuitton
WearFit2.0	WearFit2.0
柬单点	柬单点
宝宝儿童超市	儿童超市
Writer	Writer
大连航空	海南航空
白板	白板
迪士尼魔法涂色	迪士尼魔法涂色
迪士尼魔法涂色	小马宝莉魔法涂色
车坐标	地图坐标
每日天气预报	每小时天气预报
翻译软件	翻译软件
念佛计数	念佛机
Nike⁠_Run_Club	Nike_Run_Club
WoFit	WoFit
今日头条	今日头条
华阳车检	重型车辆检验
98外卖	98外卖
省钱	赚钱
智慧骑手	Smart_Ruler
Travelzoo	Travelzoo
尺子测距仪	测距仪
佛教音乐	佛教音乐
心动	心率
手机淘宝	手机淘宝
宝宝儿童动物拼图	孩子们的动物拼图
中国国航	中国国航
望远镜	望远镜
乐迪智能	LE_智能
萨马拉旅游攻略	日本旅游攻略
优酷视频	优酷视频
华为全景相机	Anole360全景相机
华为全景相机	Hi720_全景相机
航海家	SNAV_航海家
航海家	航海家
时钟	时钟
i_教英语	学英语
邦邦师傅	Hangman_Master
Crown_Heart_Photo_Editor	Crown_Heart_Emoji_Photo_Editor
去除水印	去水印
宝宝动物启蒙书	宝宝动物启蒙书
英语语法学习	学习英语语法_Learn_English_Grammar
随手记专业版	锦浪专业版
美颜相机	美妆相机
美颜相机	美白照相机_-_Beauty_Camera
美颜相机	美人相机
简单笔记Simplenote	简单的笔记
简单笔记Simplenote	Simple_Lite
题王争霸	七王争霸
奇妙恐龙帮帮队	奇妙恐龙帮帮队
21相机	21相机
吉他模拟器	吉他_模拟器
恐龙公园4	恐龙公园2
Super_Pads	超级耳朵
绘画大师	绘画大师
iCare	HiCare
MP3提取转换器	MP3提取转换器
Easybook_-_Bus,_Train,_Ferry,_Flight_&_Car_Rental	Easybook_-_Bus,_Train,_Ferry,_Flight_&_Car_Rental
超级看看	超级钩子
棉花糖直播	棉花糖直播
腾讯自选股	腾讯自选股
中华日历	中国农历
真实架子鼓	真正的鼓3D
农极客	农业新闻
有鱼智投	有鱼智投
宝宝小牧场	宝宝小牧场
铭雅装饰	猛男装修
音乐播放器Music_PlayerPro	My_Music_Player
花样文字	花样文字
国浩中医	中医中药
国浩中医	國耀中醫診所
儿童监护宝	儿童花园
钢琴大师	钢琴大师2
Notebook	Notebooks
锦浪家庭版	锦浪家庭版
银联国际	银联国际
智慧经纪人	Smart_Browser
便利贴	便利贴
FM收音机广播	电台广播
儿童拼音学习	孩子们的阿拉伯语学习
趣铃声	搞怪铃声
萨兰斯克旅游攻略	日本旅游攻略
太极拳	太极拳
电电	Электрика
地產資訊網	地產資訊網
China_Train_Booking	China_Train_Booking
空调遥控器万能	空调遥控器_daikin
空调遥控器万能	空调遥控器_carrier
结伴者	EDCompanion
人体穴位图解	人体穴位图解
永中Office	永中Office
语音聊天	声音的聊
宝宝交通工具书	宝宝交通工具书
渔书	钓鱼胡克
BMI计算器	BMI_Calculator
BMI计算器	体重指数计算器_|_BMI_Calculator
照片水印	照片水印
汉语字典通	中文字典_+
汉语字典通	中文字典
Oxford_Dictionary_of_English_&_Thesaurus	Oxford_Dictionary_of_English_&_Thesaurus
圣经	圣经
夜灯	Night_Light
智家365	智家365
奇妙咖啡餐厅	奇妙美食餐厅
奇妙咖啡餐厅	奇妙咖啡餐厅
唐诗三百首	唐诗三百首
唐诗三百首	唐詩三百首
悠音	优信
中医药在线	中医中药
中医药在线	中医自测
Colors_Splash_Photo_Editor	Color_Splash：照片编辑器
护眼	护眼仪
ChinaTV	中国电视台_(china_tv)
中国象棋大师	中国象棋游戏
超级码	超级名模
好好玩	好修女
EGYPTAIR	EGYPTAIR
掌上达人	Park_Master
Qmusic	音乐
尺子测量工具	AR尺子-测量工具
Infinite_Painter	Infinite_Painter
蔚来	维拍
宝宝爱打扫	宝宝爱打扫
宝宝幼儿园巴士	宝宝幼儿园
乐乐抓娃娃机	抓娃娃机_免费
尤克里里调音器	尤克里里调音器
极速搜索	急上昇ワード検索
节拍器	调音器，节拍器
节拍器	Metronome
GPS导航图	GPS导航地图
摸鱼塘	Fishing_Rod
糖糖万圣节	糖果万圣节
行动商学院	大亨商学院_(Tycoon_Business_School)
宝宝家园清洁	宝宝家园清洁
确幸股票	Lucky_Block
文件编辑器X	文件编辑器X
抑郁症测试	抑郁症测试
美味珍珠奶茶	美味珍珠奶茶
东亚银行	BEA_東亞銀行
小提琴调音器	小提琴调音器_-_Violin_Tuner
汽车报价	伤心的报价
日语翻译	日语掌中翻译
健康日记	死亡日记
PDF_Reader	PDF_Reader
GloryFit	Glory_Fit
备忘录	备忘录
美颜美拍照相机	美妆相机
马卡龙玩图	马卡龙玩图
腾讯视频_HD	Tencent_Video
友讯	优信
ViTrack	ViTrack
快读书	快速阅读
抽签助手	喝水助手
比分大师	养剑大师
格志日记	格志日记
大脚车总动员	大脚车总动员
快乐小鸡爱生蛋	快乐小鸡爱生蛋2
一本日记	Q日记
东方万年历	中国农历
蓝宝书	蓝书
架子鼓节拍器	鼓节拍器
音频编辑器	Auphonic_Edit
音频编辑器	音频编辑器
名片管理器	Business_Card_Scanner
鹿客智能	LE_智能
一加一	一加便签
宝宝救护手册	宝宝救护手册
Nike	牛客
芭比梦幻屋冒险	Barbie_Dreamhouse_Adventures
中医医案	中医自测
宠乐园	蜜蜂乐园
宠乐园	猫咪天堂
网易新闻HD	网易新闻
万年历日历	万年历
iTranslate	翻译
体重记录	体重记录器
儿童捕鱼拼图	孩子们音乐拼图
小蚁生活	蚂蚁的生活
爱彼迎	翼彼迎
国泰航空	国泰航空
咪友	咪嘥嘢
吾记日记	My_Diary
吾记日记	我的日记
WiFi_Mouse_Lite	WiFi_Mouse_Lite
小爱音箱	小爱音箱
屏幕整人恶作剧	屏幕恶作剧
微信	微信
GoToMeeting	GoToMeeting
吉集号司机版	的神司機版
中华新闻	中华新闻
宝宝电话	宝宝电话
国家地理	National_Geographic_DE
国家地理	国家地理
摩托邦	五子棋
买建材	建筑材料
Agoda安可达	安可达_(Agoda)
高中历史	High_School_Story
儿童英语学习	孩子们的西班牙语学习
Ok出行	Gay_Travel
恐龙汽车	恐龙农场
恐龙汽车	恐龙相机
Synology_Chat	Synology_Chat
QQ输入法	GO输入法
奇妙生日派对	奇妙生日派对
探索雅星会	探索雅星会
驾校宝典2020	Driving_School_Classics
每日艺术	DailyArt_《每日艺术》
考培助手	喝水助手
e电工	电工
宝宝消防安全	宝宝消防安全
恐龙贝克	恐龙相机
学唱歌	Learn_to_Sing
天气预报王	天气预报小部件
Bose_Connect	Bose_Connect
ChinaRadio	美国中文电台_美国中文收音机_全球多国_华语电台_US_Chinese_Radio
YCC365_Plus	YCC365_Plus
粮果蔬	Fruits_et_légumes_de_saison
宝宝机场	宝宝飞机场
宝宝懂礼貌-宝宝巴士	宝宝懂礼貌-宝宝巴士
海南航空	海南航空
美区	美国食谱
NOMO	大按钮音效-有趣的音板
约稿猫	預約通
美人鱼派对海底历险记	美人鱼：水下冒险
亿连驾驶助手	亿连驾驶助手
视频转换器	File_Converter
美容化妆教程	美容化妆教程
钓钓网	钓鱼结
驿充电	快速充电
P图神器	P图神器
迅雷手游加速器	迅游手游加速器
额度宝	支付宝
铅笔素描	铅笔素描
俄语学习	学习俄语
咪族购	义乌购
PDF转换王	PDF转换套件（PDF_Conversion_Suite）
FM收音机电台	R＆B_电台
冰激凌甜品店	🍦🍦冰淇淋甜品店
通通锁	通通锁
乐器调音器	Instrument_Tuner_Pro
星享租	租车，汽车租赁
乡旅指南	以色列_旅游指南
乡旅指南	Dubai_Travel_Guide
爱加速	手机加速
爱加速	游戏加速
悦读	読み上げ算
bodivis	bodivis
美人相机	美人相机
潮自拍	潮自拍
幕布	窗帘
模拟炒股	Stock_Market_Simulator
日本旅行官方应用	日本旅行官方应用
涂色小画家	畫家
DJ多多	DJ多多
北京空气质量	北京空气质量_-_Beijing_Air_Quality
通用万能遥控器	通用电视遥控器
早餐食谱	早餐食谱
天天学藏语	每天学韩语
小米运动	小米运动
手机银行	Mobile_Banking_流动理财
Moo日记	Food_Diary
Moo日记	月亮日記
漫画脸	宇宙赛跑
AmyExpress	AliExpress
涂装工艺	绘画礼服
太原公交	Tehran_Public_Transport
智照护	智能生活
二维码生成器	二维码生成器
Lazada_-_#1_Online_Shopping_App!	Lazada_-_#1_Online_Shopping_App
快售宝	AliExpress
易学习	轻松学
便签记事本	Notepad_记事本
便签记事本	Notepad
极速投屏	极速投屏
遥米租车	一嗨租车
IZIVAT	大按钮音效-有趣的音板
倍儿健康	Bee_Health
速新闻	快速新闻
本地天气预报	每小时天气预报
百度地图	百度地图
Business_日历	Business_Calendar_（日历）
OK支付	i繳費
秘蜂	神秘的轮子
Pixlr照片处理	Pixlr_照片处理
简拼	简拼
魅遇	咪嘥嘢
地震讯息	地震讯息
宝宝生日派对-宝宝巴士	生日派对-宝宝巴士
电视空调遥控器	空调遥控器
通话录音器	call_recorder
通话录音器	通话录音机
英语听书	英语听力
血压记录本	血压记录
网易新闻	网易新闻
手电	Flashlight
手电	手电筒
万年历	万年历
学英语	学英语
智能关怀	智能生活
年龄计算器	Age_Calculator
万能空调遥控器	Midea空调遥控器
小鹿中医	中医中药
中医有方	中医方剂
记事本	记事本
行好运	祝好运
ECOVACS_HOME	ECOVACS_HOME
机票宝	骰宝
幸运符	幸運符
别墅装修	牆壁裝飾
别墅装修	墙面装饰
别墅装修	别墅家装
随身拇指琴	随身拇指琴
减肥食谱	减肥食谱
随笔	随笔
宝宝巴士世界	宝宝巴士世界
音频转换器	音频转换器
中华字典词典	中文字典_+
中华字典词典	中文字典
密码派	Cryptomator
宝宝职业认知-宝宝巴士	宝宝行为认知—宝宝巴士
恐龙警车	恐龙警车
易转	易传
Pencil_Sketch_Art_Photo_Editor	铅笔素描_-_照片编辑器
车智能	LE_智能
虎丘导游	Audio_Tour_Guide
Sonos	Sound声音
住家装修	房屋装饰
美人鱼小公主换装	阿拉伯公主装扮
FM广播收音机	FM_收音机
Thai_Airways	Thai_Airways
古诗三百首	古诗三百首
冰淇淋工厂	冰淇淋厂
桔子计算器	Triange_Calculator
绿色星球	绿色星球2
绿色星球	绿色星球
幼儿学拼音	学习德语为孩子
迷你抓娃娃机	抓娃娃机_免费
讯飞输入法	讯飞输入法
特快翻译	特快翻译
Compass	Compass
Compass	指南针
豆瓣阅读	豆瓣阅读
猫语翻译器	语言翻译快
音乐播放器	音乐播放器
音乐播放器	music_player
品多多	拼多多
当家装修	房屋装饰
酷电吉他	最佳电吉他
酷电吉他	真正的电吉他
爱中医	中医中药
Guitar_Tuner	Guitar_Tuner
筑家装修	房屋装饰
魔漫相机	魔漫相机
星图	星图
i城建	城市建设
奇妙玩具修理店	奇妙玩具修理店
迅游手游加速器	迅游手游加速器
滑动拼图	滑动拼图
企鹅电竞直播助手	企鹅电竞直播助手
奇妙商场嘉年华	奇妙商场嘉年华
相机360	相机360
常州地铁	广州地铁通
翻页时钟	翻转时钟
美拍	维拍
VeryFitPro	VeryFitPro
指南针罗盘	Compass
指南针罗盘	指南针
视频监控	视频监控_Ivideon
新浪新闻	中国新闻
都都数学	都都数学
万年历黄历	中国农历
超级拼	超注音
MX_播放器	MX_Player
享益购物	Joyful_Shopping
汇丰银行	汇丰银行
宝宝果汁商店	宝宝果汁商店
飞行卡	Flight_Board
衣服搭配	衣服搭配
装扮动漫	装扮动漫
睡眠定时器	睡眠定时器
部落	部族
闪光灯	闪光灯
FE文件管理器专业版	FE文件管理器(专业版)
经济学人·商论	经济学人·商论
FlagFit	FlagFit
美妆相机	美人相机
Maple计算器	Maple计算器
绘画	Pinterest
看书	読み上げ算
乐享惠购	Joyful_Shopping
泡泡车	泡泡大战
泡泡车	Bubble_Wars
DJI_Fly	DJI_Fly
碰碰狐鲨鱼宝宝故事书	碰碰狐鲨鱼宝宝故事书
儿童拼图	384儿童益智
字母大冒险	水上冒险
阜新银行	大新銀行
分贝测试仪	分贝计
全球潮汐	全球潮汐
QQ邮箱	QQ邮箱
智控	AI智能控制
宝宝便利店长	宝宝便利店长
猫语翻译	语言翻译快
猫语翻译	所有语言翻译
Xrush	Crush_Crush
懒人拼图	宝宝拼图
角落壁纸	咖啡壁紙
角落壁纸	咖啡壁纸
速卖通卖家	速卖通卖家
时间表	时间表
亲伴	EDCompanion
马来语翻译,马来文翻译	语言翻译快
马来语翻译,马来文翻译	所有语言翻译
宝宝果汁店	宝宝果汁商店
向日葵远程控制	向日葵远程控制
朗读者	Reaper
OpenRice	OpenRice_开饭喇
小贝乐园	小鱼儿乐园
唐田农场	天天农场
中华美食谱	中国菜制作
英语翻译宝典	法语翻译词典
英语翻译宝典	索马里翻译词典
泡泡小镇：儿童乐园	泡泡小镇：儿童乐园
Visit_London_Official_City_Guide	Visit_London_Official_City_Guide
澳觅	澳覓
宝宝开车大冒险-宝宝巴士	宝宝开车大冒险_-_宝宝巴士
截图P图	Screenshot_Pro
HP_Smart	HP_Smart
侏罗纪救援	侏罗纪救援
小红屋全景相机	Anole360全景相机
小红屋全景相机	Hi720_全景相机
彩妆相机	化妆相机
青青日记	青青日记
语音翻译官	语音翻译
T1出行	旅かえる
挖矿达人	驾驶达人
咪鱼	咪嘥嘢
铜城办	永中Office
狗语翻译	语言翻译快
狗语翻译	所有语言翻译
二维码扫描器	QR二维码扫描仪
宝宝幼儿园	宝宝幼儿园
通话录音	通话录音
疯狂阅读	疯狂赛车
核一下	トゥギャッター_/_話題のネタやニュースをまとめてチェック！
秘密花园	秘密花园
英语AI听说	English_Listening_and_Speaking
宝宝梦想小镇	宝宝梦想小镇
整点报时	整點報時
奇妙的动物家庭	奇妙的动物家庭
Fotor照片编辑器	Moto_照片编辑器
巴士门	Bus_Game
暴雪战网	暴雪战网
万圣节舞会	Halloween_Blast
PDF阅读器	PDF_Reader
计数器	Counter
计数器	计数器
文件管理器File_Manager	文件管理器_(File_Manager)
飞速商家端	FD商家端
Neat_Reader	News_Reader
